Welche Zutaten kann man für mehr als zwei Rezepte verwenden	 (listValue (countComparative (getProperty (singleton en.ingredient) (string !type)) (reverse (string requires)) (string >) (number 2) (getProperty (singleton en.recipe) (string !type))))
Welche Küche bereitet Reispudding vor	 (listValue (getProperty en.recipe.rice_pudding (string cuisine)))
Welches Rezept wurde 2004 veröffentlicht	 (listValue (filter (filter (getProperty (singleton en.recipe) (string !type)) (string posting_date) (string =) (date 2004 -1 -1)) (string posting_date) (string =) (date 2004 -1 -1)))
Welches Rezept das 2004 gepostet wurde benötigt Milch	 (listValue (filter (filter (getProperty (singleton en.recipe) (string !type)) (string posting_date) (string =) (date 2004 -1 -1)) (string requires) (string =) en.ingredient.milk))
Welches Rezept kocht nicht länger als die Zubereitungszeit von Milchreis	 (listValue (filter (getProperty (singleton en.recipe) (string !type)) (ensureNumericProperty (string cooking_time)) (string <=) (ensureNumericEntity (getProperty en.recipe.rice_pudding (string preparation_time)))))
Welches Rezept braucht die wenigsten Küchen	 (listValue (countSuperlative (getProperty (singleton en.recipe) (string !type)) (string min) (string cuisine)))
Welche Rezepte sind als Mittagessen gedacht	 (listValue (filter (filter (getProperty (singleton en.recipe) (string !type)) (string meal) (string =) en.meal.lunch) (string meal) (string =) en.meal.lunch))
Welche Rezepte benötigen Milch oder Spinat	 (listValue (filter (getProperty (singleton en.recipe) (string !type)) (string requires) (string =) (concat en.ingredient.milk en.ingredient.spinach)))
Zu welcher Mahlzeit werden Reispudding oder Quiche gegessen	 (listValue (filter (getProperty (singleton en.meal) (string !type)) (reverse (string meal)) (string =) (concat en.recipe.rice_pudding en.recipe.quiche)))
Welches Rezept ergibt weniger als zwei Portionen	 (listValue (countComparative (getProperty (singleton en.recipe) (string !type)) (string meal) (string <) (number 2) (getProperty (singleton en.meal) (string !type))))
Welches Rezept benötigt eine kürzere Kochzeit als Reispudding	 (listValue (filter (getProperty (singleton en.recipe) (string !type)) (ensureNumericProperty (string cooking_time)) (string <) (ensureNumericEntity (getProperty en.recipe.rice_pudding (string cooking_time)))))
Anzahl der Inhaltstoffe	 (listValue (call .size (getProperty (singleton en.ingredient) (string !type))))
Welche Nummer hat das Gericht	 (listValue (call .size (getProperty (singleton en.meal) (string !type))))
Welches Rezept benötigt die größte Menge an Zutaten	 (listValue (countSuperlative (getProperty (singleton en.recipe) (string !type)) (string max) (string requires) (getProperty (singleton en.ingredient) (string !type))))
Welches Rezept hat eine längere Vorbereitungszeit als die Kochzeit von Reispudding	 (listValue (filter (getProperty (singleton en.recipe) (string !type)) (ensureNumericProperty (string preparation_time)) (string >) (ensureNumericEntity (getProperty en.recipe.rice_pudding (string cooking_time)))))
Welches Rezept wurde spätestens 2004 gepostet	 (listValue (filter (getProperty (singleton en.recipe) (string !type)) (ensureNumericProperty (string posting_date)) (string <=) (ensureNumericEntity (date 2004 -1 -1))))
Welches Rezept benoetigt nicht laenger als die Kochzeit fuer Reisbrei	 (listValue (filter (getProperty (singleton en.recipe) (string !type)) (ensureNumericProperty (string cooking_time)) (string <=) (ensureNumericEntity (getProperty en.recipe.rice_pudding (string cooking_time)))))
Für welches Rezept braucht man länger als es dauert Reispudding zu kochen	 (listValue (filter (getProperty (singleton en.recipe) (string !type)) (ensureNumericProperty (string preparation_time)) (string >) (ensureNumericEntity (getProperty en.recipe.rice_pudding (string cooking_time)))))
Ist bei diesem Rezept die angegebene Kochzeit hauptsächlich die Zeit die man zum Kochen von Milchreis benötigt	 (listValue (filter (getProperty (singleton en.recipe) (string !type)) (ensureNumericProperty (string cooking_time)) (string <=) (ensureNumericEntity (getProperty en.recipe.rice_pudding (string cooking_time)))))
Welches Rezept braucht nicht länger als Milchreis	 (listValue (filter (getProperty (singleton en.recipe) (string !type)) (ensureNumericProperty (string cooking_time)) (string <=) (ensureNumericEntity (getProperty en.recipe.rice_pudding (string cooking_time)))))
Kennst du ein Rezept das nach 2004 bekannt wurde	 (listValue (filter (getProperty (singleton en.recipe) (string !type)) (ensureNumericProperty (string posting_date)) (string >) (ensureNumericEntity (date 2004 -1 -1))))
Welches Rezept hat mindestens die gleiche Zubereitungszeit wie Reispudding	 (listValue (filter (getProperty (singleton en.recipe) (string !type)) (ensureNumericProperty (string preparation_time)) (string >=) (ensureNumericEntity (getProperty en.recipe.rice_pudding (string preparation_time)))))
Welches Rezept stammt aus höchstens zwei Küchen	 (listValue (countComparative (getProperty (singleton en.recipe) (string !type)) (string cuisine) (string <=) (number 2)))
Ist es ein Rezept welches 2004 oder 2010 gepostet wurde	 (listValue (filter (getProperty (singleton en.recipe) (string !type)) (string posting_date) (string =) (concat (date 2004 -1 -1) (date 2010 -1 -1))))
Welches Rezept hat die längste Kochzeit	 (listValue (superlative (getProperty (singleton en.recipe) (string !type)) (string max) (ensureNumericProperty (string cooking_time))))
Gibt es ein Rezept welches wenigstens 2004 oder 2010 gepostet würde	 (listValue (filter (getProperty (singleton en.recipe) (string !type)) (ensureNumericProperty (string posting_date)) (string >=) (ensureNumericEntity (concat (date 2004 -1 -1) (date 2010 -1 -1)))))
Welches Rezept wird am meisten in der Küche verwendet	 (listValue (countSuperlative (getProperty (singleton en.recipe) (string !type)) (string max) (string cuisine)))
Was ist die Kochzeit von Reispudding	 (listValue (getProperty en.recipe.rice_pudding (string cooking_time)))
Welche Mahlzeit hat höchstens zwei zugehörige Rezepte	 (listValue (countComparative (getProperty (singleton en.meal) (string !type)) (reverse (string meal)) (string <=) (number 2) (getProperty (singleton en.recipe) (string !type))))
Für welches Gericht gibt es die meisten Rezepte	 (listValue (countSuperlative (getProperty (singleton en.meal) (string !type)) (string max) (reverse (string meal)) (getProperty (singleton en.recipe) (string !type))))
Welches Rezept benötigt keine Milch	 (listValue (filter (getProperty (singleton en.recipe) (string !type)) (string requires) (string !=) en.ingredient.milk))
Bei welchen Rezepten dauert die Zubereitung ungefähr so lang wie die Zubereitung von Reispudding	 (listValue (filter (getProperty (singleton en.recipe) (string !type)) (ensureNumericProperty (string preparation_time)) (string <=) (ensureNumericEntity (getProperty en.recipe.rice_pudding (string preparation_time)))))
Welche Rezepte haben die selbe Zubereitungszeit wie die von Milchreis	 (listValue (filter (getProperty (singleton en.recipe) (string !type)) (ensureNumericProperty (string preparation_time)) (string <=) (ensureNumericEntity (getProperty en.recipe.rice_pudding (string preparation_time)))))
Welches Rezept benoetigt zur Vorbereitung nicht laenger als Reisbrei	 (listValue (filter (getProperty (singleton en.recipe) (string !type)) (ensureNumericProperty (string cooking_time)) (string <=) (ensureNumericEntity (getProperty en.recipe.rice_pudding (string preparation_time)))))
Welches Rezept braucht die gleiche Zeit zur Zubereitung wie Reispudding	 (listValue (filter (getProperty (singleton en.recipe) (string !type)) (string cooking_time) (string =) (getProperty en.recipe.rice_pudding (string preparation_time))))
Was ist ein Gericht dass nichts mit Reispudding zu tun hat	 (listValue (filter (getProperty (singleton en.meal) (string !type)) (reverse (string meal)) (string !=) en.recipe.rice_pudding))
Welches Rezept ist in den meisten Küchen am häufigsten verbreitet	 (listValue (countSuperlative (getProperty (singleton en.recipe) (string !type)) (string max) (string cuisine)))
Welches Rezept hat die längste Zubereitungsdauer	 (listValue (superlative (getProperty (singleton en.recipe) (string !type)) (string max) (ensureNumericProperty (string preparation_time))))
Welches Rezept für ein Mittagessen benötigt Milch	 (listValue (filter (filter (getProperty (singleton en.recipe) (string !type)) (string requires) (string =) en.ingredient.milk) (string meal) (string =) en.meal.lunch))
Welches Rezept hat die kürzeste Zubereitungszeit	 (listValue (superlative (getProperty (singleton en.recipe) (string !type)) (string min) (ensureNumericProperty (string preparation_time))))
Welches Rezept eignet sich für die wenigsten Mahlzeiten	 (listValue (countSuperlative (getProperty (singleton en.recipe) (string !type)) (string min) (string meal) (getProperty (singleton en.meal) (string !type))))
2004 oder 2010	 (listValue (concat (date 2004 -1 -1) (date 2010 -1 -1)))
Für welches Gericht sind die zwei Rezepte	 (listValue (countComparative (getProperty (singleton en.meal) (string !type)) (reverse (string meal)) (string >=) (number 2) (getProperty (singleton en.recipe) (string !type))))
Welches Gericht passt zu Reispudding oder Quiche	 (listValue (filter (getProperty (singleton en.meal) (string !type)) (reverse (string meal)) (string =) (concat en.recipe.rice_pudding en.recipe.quiche)))
Welches Rezept benötigt eine kürzere Kochzeit als Reispudding	 (listValue (filter (getProperty (singleton en.recipe) (string !type)) (ensureNumericProperty (string preparation_time)) (string <) (ensureNumericEntity (getProperty en.recipe.rice_pudding (string cooking_time)))))
Ein Rezept für Abendessen dass 2004 veröffentlicht wurde	 (listValue (filter (filter (getProperty (singleton en.recipe) (string !type)) (string posting_date) (string =) (date 2004 -1 -1)) (string meal) (string =) en.meal.lunch))
Welches Rezept ist für die kleinste Anzahl an Mahlzeiten gedacht	 (listValue (countSuperlative (getProperty (singleton en.recipe) (string !type)) (string min) (string meal) (getProperty (singleton en.meal) (string !type))))
Hast du ein Rezept welches eine kürzere Kochzeit hat als die Zubereitungszeit von Reispudding	 (listValue (filter (getProperty (singleton en.recipe) (string !type)) (ensureNumericProperty (string cooking_time)) (string <) (ensureNumericEntity (getProperty en.recipe.rice_pudding (string preparation_time)))))
Welches Rezept braucht höchstens zwei Zutaten	 (listValue (countComparative (getProperty (singleton en.ingredient) (string !type)) (reverse (string requires)) (string <=) (number 2) (getProperty (singleton en.recipe) (string !type))))
Kennst du ein Rezept dass Milch benötigt	 (listValue (filter (getProperty (singleton en.meal) (string !type)) (reverse (string meal)) (string =) (filter (getProperty (singleton en.recipe) (string !type)) (string requires) (string =) en.ingredient.milk)))
Reispudding oder Quiche	 (listValue (concat en.recipe.rice_pudding en.recipe.quiche))
Welches Rezept ist schneller zubereitet als Milchreis	 (listValue (filter (getProperty (singleton en.recipe) (string !type)) (ensureNumericProperty (string preparation_time)) (string <) (ensureNumericEntity (getProperty en.recipe.rice_pudding (string preparation_time)))))
Welches Rezept hat ein Einreichungsdatum kleiner als 2004	 (listValue (filter (getProperty (singleton en.recipe) (string !type)) (ensureNumericProperty (string posting_date)) (string <) (ensureNumericEntity (date 2004 -1 -1))))
Anzahl der Mahlzeiten	 (listValue (call .size (getProperty (singleton en.meal) (string !type))))
Welches Rezept passt zu Milchreis	 (listValue (filter (getProperty (singleton en.recipe) (string !type)) (string meal) (string =) (filter (getProperty (singleton en.meal) (string !type)) (reverse (string meal)) (string =) en.recipe.rice_pudding)))
Welches Rezept für ein Mittagessen wurde 2004 veröffentlicht	 (listValue (filter (filter (getProperty (singleton en.recipe) (string !type)) (string posting_date) (string =) (date 2004 -1 -1)) (string meal) (string =) en.meal.lunch))
Kennst du ein Rezept das Milch oder Spinat beinhalte	 (listValue (filter (getProperty (singleton en.recipe) (string !type)) (string requires) (string =) (concat en.ingredient.milk en.ingredient.spinach)))
Was ist eine Zutat die man für Reispudding nicht braucht	 (listValue (filter (getProperty (singleton en.ingredient) (string !type)) (reverse (string requires)) (string !=) en.recipe.rice_pudding))
Reispudding oder eine Quiche	 (listValue (concat en.recipe.rice_pudding en.recipe.quiche))
Was ist das Rezept das am ältesten in der Datenbank enthalten ist	 (listValue (superlative (getProperty (singleton en.recipe) (string !type)) (string max) (ensureNumericProperty (string posting_date))))
Welche Rezepte stammen nicht aus dem Jahr 2004	 (listValue (filter (getProperty (singleton en.recipe) (string !type)) (string posting_date) (string !=) (date 2004 -1 -1)))
Welches Rezept von einem Mittagessen ist 2004 geschrieben	 (listValue (filter (filter (getProperty (singleton en.recipe) (string !type)) (string meal) (string =) en.meal.lunch) (string posting_date) (string =) (date 2004 -1 -1)))
Womit sollte man Milchreis nicht kombinieren	 (listValue (filter (getProperty (singleton en.meal) (string !type)) (reverse (string meal)) (string !=) en.recipe.rice_pudding))
Welches Rezept benötigt Milch als Zutat	 (listValue (filter (getProperty (singleton en.ingredient) (string !type)) (reverse (string requires)) (string =) (filter (getProperty (singleton en.recipe) (string !type)) (string requires) (string =) en.ingredient.milk)))
Welche Mahlzeit für die es mehr als zwei Rezepte gibt	 (listValue (countComparative (getProperty (singleton en.meal) (string !type)) (reverse (string meal)) (string >) (number 2) (getProperty (singleton en.recipe) (string !type))))
Was ist ein Essen das man ohne Reispudding macht	 (listValue (filter (getProperty (singleton en.meal) (string !type)) (reverse (string meal)) (string !=) en.recipe.rice_pudding))
Welches Rezept wurde nach 2004 oder 2010 veröffentlicht	 (listValue (filter (getProperty (singleton en.recipe) (string !type)) (ensureNumericProperty (string posting_date)) (string >) (ensureNumericEntity (concat (date 2004 -1 -1) (date 2010 -1 -1)))))
Dieser Reispudding ist für	 (listValue (filter (getProperty (singleton en.meal) (string !type)) (reverse (string meal)) (string =) en.recipe.rice_pudding))
Welches Rezept braucht höchstens zwei Zutaten	 (listValue (countComparative (getProperty (singleton en.recipe) (string !type)) (string requires) (string <=) (number 2) (getProperty (singleton en.ingredient) (string !type))))
Welche Zutat wird in mindestens zwei Rezepten benötigt	 (listValue (countComparative (getProperty (singleton en.ingredient) (string !type)) (reverse (string requires)) (string >=) (number 2) (getProperty (singleton en.recipe) (string !type))))
Welches Rezept ist mit Milch oder Spinat gemacht	 (listValue (filter (getProperty (singleton en.recipe) (string !type)) (string requires) (string =) (concat en.ingredient.milk en.ingredient.spinach)))
Welche Zutat benötigt zwei Rezepte	 (listValue (countComparative (getProperty (singleton en.ingredient) (string !type)) (reverse (string requires)) (string =) (number 2) (getProperty (singleton en.recipe) (string !type))))
Welches Rezept benötigt höchstens zwei Zutaten	 (listValue (countComparative (getProperty (singleton en.recipe) (string !type)) (string requires) (string <=) (number 2) (getProperty (singleton en.ingredient) (string !type))))
Welches Rezept das für weniger als zwei Mahlzeiten gedacht ist	 (listValue (countComparative (getProperty (singleton en.recipe) (string !type)) (string meal) (string <) (number 2) (getProperty (singleton en.meal) (string !type))))
Benötigt das Rezept Milch	 (listValue (filter (filter (getProperty (singleton en.recipe) (string !type)) (string requires) (string =) en.ingredient.milk) (string requires) (string =) en.ingredient.milk))
Für welches Gericht wurde ein Rezept in 2004 gepostet	 (listValue (filter (getProperty (singleton en.meal) (string !type)) (reverse (string meal)) (string =) (filter (getProperty (singleton en.recipe) (string !type)) (string posting_date) (string =) (date 2004 -1 -1))))
Ein Gericht mit zwei Rezepten	 (listValue (countComparative (getProperty (singleton en.meal) (string !type)) (reverse (string meal)) (string =) (number 2) (getProperty (singleton en.recipe) (string !type))))
Welches Rezept ist für das Mittagessen	 (listValue (filter (getProperty (singleton en.meal) (string !type)) (reverse (string meal)) (string =) (filter (getProperty (singleton en.recipe) (string !type)) (string meal) (string =) en.meal.lunch)))
Für welches Mahl für weniger als zwei Leute ist dieses Rezept	 (listValue (countComparative (getProperty (singleton en.meal) (string !type)) (reverse (string meal)) (string <) (number 2) (getProperty (singleton en.recipe) (string !type))))
Welches Rezept hat eine Progresse Menge als das von Milchreis	 (listValue (filter (getProperty (singleton en.recipe) (string !type)) (ensureNumericProperty (string posting_date)) (string >) (ensureNumericEntity (getProperty en.recipe.rice_pudding (string posting_date)))))
Welche Rezepte haben ein späteres Veröffentlichungsdatum als das Reispudding Rezept	 (listValue (filter (getProperty (singleton en.recipe) (string !type)) (ensureNumericProperty (string posting_date)) (string >) (ensureNumericEntity (getProperty en.recipe.rice_pudding (string posting_date)))))
Welche Zutat wird von den meisten Rezepten verwendet	 (listValue (countSuperlative (getProperty (singleton en.ingredient) (string !type)) (string max) (reverse (string requires)) (getProperty (singleton en.recipe) (string !type))))
Wie viele Rezepte gibt es	 (listValue (call .size (getProperty (singleton en.recipe) (string !type))))
Welches Rezept hat die längste Zubereitungszeit	 (listValue (superlative (getProperty (singleton en.recipe) (string !type)) (string max) (ensureNumericProperty (string preparation_time))))
Welches Rezept hat weniger als zwei verschiedene Küchen	 (listValue (countComparative (getProperty (singleton en.recipe) (string !type)) (string cuisine) (string <) (number 2)))
Wurde das Rezept 2004 gepostet	 (listValue (filter (getProperty (singleton en.recipe) (string !type)) (string posting_date) (string =) (date 2004 -1 -1)))
Ein Rezept was genau so lange braucht wie das Kochen von Reispudding	 (listValue (filter (getProperty (singleton en.recipe) (string !type)) (ensureNumericProperty (string preparation_time)) (string >=) (ensureNumericEntity (getProperty en.recipe.rice_pudding (string cooking_time)))))
Für welche Mahlzeit werden die wenigsten Rezepte benötigt	 (listValue (countSuperlative (getProperty (singleton en.meal) (string !type)) (string min) (reverse (string meal)) (getProperty (singleton en.recipe) (string !type))))
Wie lang dauert es Milchreis zu kochen	 (listValue (getProperty en.recipe.rice_pudding (string preparation_time)))
Welches Rezept von 2003 benötigt Milch	 (listValue (filter (filter (getProperty (singleton en.recipe) (string !type)) (string posting_date) (string =) (date 2004 -1 -1)) (string requires) (string =) en.ingredient.milk))
Welche Rezepte sind eine Mischung aus zwei Küchen	 (listValue (countComparative (getProperty (singleton en.recipe) (string !type)) (string cuisine) (string =) (number 2)))
Welches Rezept hat eine geringere Zubereitungszeit als Reispudding	 (listValue (filter (getProperty (singleton en.recipe) (string !type)) (ensureNumericProperty (string cooking_time)) (string <) (ensureNumericEntity (getProperty en.recipe.rice_pudding (string preparation_time)))))
Für welche Mahlzeit kennt ihr zwei Rezepte	 (listValue (countComparative (getProperty (singleton en.meal) (string !type)) (reverse (string meal)) (string >=) (number 2) (getProperty (singleton en.recipe) (string !type))))
Welches Rezept wurde am gleichen Datum wie das Reispudding-Rezept gepostet	 (listValue (filter (getProperty (singleton en.recipe) (string !type)) (string posting_date) (string =) (getProperty en.recipe.rice_pudding (string posting_date))))
Was ist ein Rezept das am selben Tag wie Reispudding gepostet wurde	 (listValue (filter (getProperty (singleton en.recipe) (string !type)) (string posting_date) (string =) (getProperty en.recipe.rice_pudding (string posting_date))))
Welches Rezept benötigt die meisten Zutaten	 (listValue (countSuperlative (getProperty (singleton en.recipe) (string !type)) (string max) (string requires) (getProperty (singleton en.ingredient) (string !type))))
Welches Rezept ist schon am längsten in der Datenbank	 (listValue (superlative (getProperty (singleton en.recipe) (string !type)) (string max) (ensureNumericProperty (string posting_date))))
Welches Rezept hat die kürzeste Kochzeit	 (listValue (superlative (getProperty (singleton en.recipe) (string !type)) (string min) (ensureNumericProperty (string cooking_time))))
Ein Rezept mit nur zwei Zutaten	 (listValue (countComparative (getProperty (singleton en.recipe) (string !type)) (string requires) (string =) (number 2) (getProperty (singleton en.ingredient) (string !type))))
Welches Rezept wurde mindestens 2004 gepostet	 (listValue (filter (getProperty (singleton en.recipe) (string !type)) (ensureNumericProperty (string posting_date)) (string >=) (ensureNumericEntity (date 2004 -1 -1))))
Welches Rezept braucht nicht länger als Milchreis	 (listValue (filter (getProperty (singleton en.recipe) (string !type)) (ensureNumericProperty (string cooking_time)) (string <=) (ensureNumericEntity (getProperty en.recipe.rice_pudding (string preparation_time)))))
Für welches Gericht gibt es Rezepte für 2 Personen oder weniger	 (listValue (countComparative (getProperty (singleton en.meal) (string !type)) (reverse (string meal)) (string <) (number 2) (getProperty (singleton en.recipe) (string !type))))
Welches Rezept benötigt Milch oder Spinat	 (listValue (concat en.ingredient.milk en.ingredient.spinach))
Welches Rezept benötigt höchstens zwei Zutaten	 (listValue (countComparative (getProperty (singleton en.ingredient) (string !type)) (reverse (string requires)) (string <=) (number 2) (getProperty (singleton en.recipe) (string !type))))
Welche Rezepte kommen in mehr als zwei Küchen vor	 (listValue (countComparative (getProperty (singleton en.recipe) (string !type)) (string cuisine) (string >) (number 2)))
Welche Vorbereitungszeit von Reispudding	 (listValue (getProperty en.recipe.rice_pudding (string preparation_time)))
Gibt es ein Gericht das wie Reispudding ist	 (listValue (filter (getProperty (singleton en.meal) (string !type)) (reverse (string meal)) (string =) en.recipe.rice_pudding))
Welches Rezept reicht für mehr als zwei Mahlzeiten	 (listValue (countComparative (getProperty (singleton en.meal) (string !type)) (reverse (string meal)) (string =) (number 2) (getProperty (singleton en.recipe) (string !type))))
Ich suche ein Rezept welches genau so lange zubereitet wird wie Milchreis	 (listValue (filter (getProperty (singleton en.recipe) (string !type)) (ensureNumericProperty (string preparation_time)) (string <=) (ensureNumericEntity (getProperty en.recipe.rice_pudding (string preparation_time)))))
Welche Rezepte wurden maximal 2004 oder 2010 gepostet	 (listValue (filter (getProperty (singleton en.recipe) (string !type)) (ensureNumericProperty (string posting_date)) (string <=) (ensureNumericEntity (concat (date 2004 -1 -1) (date 2010 -1 -1)))))
Ein Rezept dass mindestens so alt ist wie das von Reispudding	 (listValue (filter (getProperty (singleton en.recipe) (string !type)) (ensureNumericProperty (string posting_date)) (string >=) (ensureNumericEntity (getProperty en.recipe.rice_pudding (string posting_date)))))
Für welches Gericht gibt es zwei Rezepte	 (listValue (countComparative (getProperty (singleton en.meal) (string !type)) (reverse (string meal)) (string =) (number 2) (getProperty (singleton en.recipe) (string !type))))
Welches Rezept dauert mindestens so lange wie Reispudding	 (listValue (filter (getProperty (singleton en.recipe) (string !type)) (ensureNumericProperty (string preparation_time)) (string >=) (ensureNumericEntity (getProperty en.recipe.rice_pudding (string preparation_time)))))
Welche Rezepte benötigen die selben Zutaten wie Milchreis	 (listValue (filter (getProperty (singleton en.recipe) (string !type)) (string requires) (string =) (filter (getProperty (singleton en.ingredient) (string !type)) (reverse (string requires)) (string =) en.recipe.rice_pudding)))
Welches Rezept hat die längste Kochdauer	 (listValue (superlative (getProperty (singleton en.recipe) (string !type)) (string max) (ensureNumericProperty (string cooking_time))))
Welches Rezept hat die gleiche Kochzeit wie Reispudding	 (listValue (filter (getProperty (singleton en.recipe) (string !type)) (ensureNumericProperty (string cooking_time)) (string >=) (ensureNumericEntity (getProperty en.recipe.rice_pudding (string cooking_time)))))
Wie lange dauert die Zubereitung des Rezeptes insgesamt	 (listValue (aggregate (string sum) (getProperty (getProperty (singleton en.recipe) (string !type)) (string preparation_time))))
Welche Zutat benötigt Reispudding	 (listValue (filter (getProperty (singleton en.ingredient) (string !type)) (reverse (string requires)) (string =) en.recipe.rice_pudding))
Wie ist die durchschnittliche Kochzeit des Rezeptes	 (listValue (aggregate (string avg) (getProperty (getProperty (singleton en.recipe) (string !type)) (string cooking_time))))
Brauchen wir diese Zutat für mehr als zwei Rezepte	 (listValue (countComparative (getProperty (singleton en.ingredient) (string !type)) (reverse (string requires)) (string >) (number 2) (getProperty (singleton en.recipe) (string !type))))
Für welches Gericht gibt es mehr als zwei Rezepte	 (listValue (countComparative (getProperty (singleton en.meal) (string !type)) (reverse (string meal)) (string >) (number 2) (getProperty (singleton en.recipe) (string !type))))
Ein Rezept dessen Kochzeit Vorbereitungszeit für Reispudding ist	 (listValue (filter (getProperty (singleton en.recipe) (string !type)) (string cooking_time) (string =) (getProperty en.recipe.rice_pudding (string preparation_time))))
Welche Speise muss man so lange kochen wie es dauert Reispudding zu kochen	 (listValue (filter (getProperty (singleton en.recipe) (string !type)) (string cooking_time) (string =) (getProperty en.recipe.rice_pudding (string cooking_time))))
Welches Gericht hat die meiste Anzahl an Rezepten	 (listValue (countSuperlative (getProperty (singleton en.meal) (string !type)) (string max) (reverse (string meal)) (getProperty (singleton en.recipe) (string !type))))
Welche Zutat kommt nicht in Milchreis rein	 (listValue (filter (getProperty (singleton en.ingredient) (string !type)) (reverse (string requires)) (string !=) en.recipe.rice_pudding))
Welches Rezept benötigt die gleichen Zutaten wie das Reispudding Rezept	 (listValue (filter (getProperty (singleton en.recipe) (string !type)) (string requires) (string =) (filter (getProperty (singleton en.ingredient) (string !type)) (reverse (string requires)) (string =) en.recipe.rice_pudding)))
Welches Rezept braucht Milch und ist für das Mittagessen	 (listValue (filter (filter (getProperty (singleton en.recipe) (string !type)) (string requires) (string =) en.ingredient.milk) (string meal) (string =) en.meal.lunch))
Wie ist die gesamte Kochzeit des Rezepts	 (listValue (aggregate (string sum) (getProperty (getProperty (singleton en.recipe) (string !type)) (string cooking_time))))
Wie lang ist die durchschnittliche Vorbereitungszeit bei Rezepten	 (listValue (aggregate (string avg) (getProperty (getProperty (singleton en.recipe) (string !type)) (string preparation_time))))
Welches Rezept benötigt die meisten Zutaten	 (listValue (countSuperlative (getProperty (singleton en.recipe) (string !type)) (string max) (string requires) (getProperty (singleton en.ingredient) (string !type))))
Die Kochzeit von welchem Rezept dauert mindestens so lange wie die Vorbereitungszeit von Reispudding	 (listValue (filter (getProperty (singleton en.recipe) (string !type)) (ensureNumericProperty (string cooking_time)) (string >=) (ensureNumericEntity (getProperty en.recipe.rice_pudding (string preparation_time)))))
Für welches Gericht ist Reispudding oder Quiche	 (listValue (filter (getProperty (singleton en.meal) (string !type)) (reverse (string meal)) (string =) (concat en.recipe.rice_pudding en.recipe.quiche)))
Welches Rezept ist für Milchreis	 (listValue (filter (getProperty (singleton en.recipe) (string !type)) (string meal) (string =) (filter (getProperty (singleton en.meal) (string !type)) (reverse (string meal)) (string =) en.recipe.rice_pudding)))
Hat das Rezept eine kürzere Kochzeit als Reispudding	 (listValue (filter (getProperty (singleton en.recipe) (string !type)) (ensureNumericProperty (string cooking_time)) (string <) (ensureNumericEntity (getProperty en.recipe.rice_pudding (string cooking_time)))))
Anzahl der Rezepte	 (listValue (call .size (getProperty (singleton en.recipe) (string !type))))
Kennst du ein Rezept welches auf Milchreis basiert	 (listValue (filter (getProperty (singleton en.recipe) (string !type)) (string cuisine) (string =) (getProperty en.recipe.rice_pudding (string cuisine))))
Welches Rezept wurde nach 2004 gepostet	 (listValue (filter (getProperty (singleton en.recipe) (string !type)) (ensureNumericProperty (string posting_date)) (string <) (ensureNumericEntity (date 2004 -1 -1))))
Für welches Rezept braucht man Milch	 (listValue (filter (getProperty (singleton en.meal) (string !type)) (reverse (string meal)) (string =) (filter (getProperty (singleton en.recipe) (string !type)) (string requires) (string =) en.ingredient.milk)))
Benötigt man keine Milch bei diesem Rezept 	 (listValue (filter (getProperty (singleton en.recipe) (string !type)) (string requires) (string !=) en.ingredient.milk))
Was ist die durchschnittliche Kochzeit des Rezepts	 (listValue (aggregate (string avg) (getProperty (getProperty (singleton en.recipe) (string !type)) (string cooking_time))))
Wird diese Zutat für nicht mehr als zwei Rezepte benötigt	 (listValue (countComparative (getProperty (singleton en.ingredient) (string !type)) (reverse (string requires)) (string <=) (number 2) (getProperty (singleton en.recipe) (string !type))))
Wie ist die Anzahl der Rezepte	 (listValue (call .size (getProperty (singleton en.recipe) (string !type))))
Mittag oder Abendessen	 (listValue (concat en.meal.lunch en.meal.dinner))
Welche Zutat enthält Reispudding nicht	 (listValue (filter (getProperty (singleton en.ingredient) (string !type)) (reverse (string requires)) (string !=) en.recipe.rice_pudding))
Milch oder Spinat	 (listValue (concat en.ingredient.milk en.ingredient.spinach))
Welche Inhaltsstoffe sind vorhanden	 (listValue (call .size (getProperty (singleton en.ingredient) (string !type))))
Welches Rezept für das Mittagessen	 (listValue (filter (filter (getProperty (singleton en.recipe) (string !type)) (string meal) (string =) en.meal.lunch) (string meal) (string =) en.meal.lunch))
Welches Rezept hat eine kürzere Vorbereitungszeit wie die Kochzeit von Reispudding	 (listValue (filter (getProperty (singleton en.recipe) (string !type)) (ensureNumericProperty (string preparation_time)) (string <) (ensureNumericEntity (getProperty en.recipe.rice_pudding (string cooking_time)))))
Welche Rezepte enthalten Milch	 (listValue (filter (getProperty (singleton en.recipe) (string !type)) (string requires) (string =) en.ingredient.milk))
Welche Rezepte haben die gleiche Kochzeit wie Reispudding	 (listValue (filter (getProperty (singleton en.recipe) (string !type)) (string cooking_time) (string =) (getProperty en.recipe.rice_pudding (string cooking_time))))
Welches Rezept würde später als 2004 oder 2010 gepostet	 (listValue (filter (getProperty (singleton en.recipe) (string !type)) (ensureNumericProperty (string posting_date)) (string >) (ensureNumericEntity (concat (date 2004 -1 -1) (date 2010 -1 -1)))))
Für welches Rezept ist die Vorbereitungszeit mindestens so lange wie die Kochzeit von Reispudding	 (listValue (filter (getProperty (singleton en.recipe) (string !type)) (ensureNumericProperty (string preparation_time)) (string >=) (ensureNumericEntity (getProperty en.recipe.rice_pudding (string cooking_time)))))
Bei welchen Rezepten dauert die Vorbereitungszeit länger als Reispudding kochen muss	 (listValue (filter (getProperty (singleton en.recipe) (string !type)) (ensureNumericProperty (string preparation_time)) (string >) (ensureNumericEntity (getProperty en.recipe.rice_pudding (string cooking_time)))))
Welches Rezept entspricht von der Zubereitungsdauer einem Reispudding	 (listValue (filter (getProperty (singleton en.recipe) (string !type)) (ensureNumericProperty (string cooking_time)) (string <=) (ensureNumericEntity (getProperty en.recipe.rice_pudding (string preparation_time)))))
Welches Rezept hat eine Kochzeit die mindestens so lange ist wie die von Reispudding	 (listValue (filter (getProperty (singleton en.recipe) (string !type)) (ensureNumericProperty (string cooking_time)) (string >=) (ensureNumericEntity (getProperty en.recipe.rice_pudding (string cooking_time)))))
Welches Rezept erfordert mindestens zwei Zutaten	 (listValue (countComparative (getProperty (singleton en.recipe) (string !type)) (string requires) (string >=) (number 2) (getProperty (singleton en.ingredient) (string !type))))
Welches Rezept für Mittagessen wurde 2004 gepostet	 (listValue (filter (filter (getProperty (singleton en.recipe) (string !type)) (string posting_date) (string =) (date 2004 -1 -1)) (string meal) (string =) en.meal.lunch))
Welches Rezept hat die selbe Zubereitungszeit wie Milchreis	 (listValue (filter (getProperty (singleton en.recipe) (string !type)) (string preparation_time) (string =) (getProperty en.recipe.rice_pudding (string preparation_time))))
In welchem Rezept wird Milch als Zutat benötigt	 (listValue (filter (getProperty (singleton en.ingredient) (string !type)) (reverse (string requires)) (string =) (filter (getProperty (singleton en.recipe) (string !type)) (string requires) (string =) en.ingredient.milk)))
Welche Zutaten die für höchstens zwei Rezepte benötigt werden	 (listValue (countComparative (getProperty (singleton en.ingredient) (string !type)) (reverse (string requires)) (string <) (number 2) (getProperty (singleton en.recipe) (string !type))))
Was ist das Rezept dessen Vorbereitung laenger dauert als die des Reispuddings	 (listValue (filter (getProperty (singleton en.recipe) (string !type)) (ensureNumericProperty (string preparation_time)) (string >) (ensureNumericEntity (getProperty en.recipe.rice_pudding (string preparation_time)))))
Für welches Gericht gibt es höchstens zwei Rezepte	 (listValue (countComparative (getProperty (singleton en.meal) (string !type)) (reverse (string meal)) (string <=) (number 2) (getProperty (singleton en.recipe) (string !type))))
Welches Rezept benötigt weniger als zwei Zutaten	 (listValue (countComparative (getProperty (singleton en.recipe) (string !type)) (string requires) (string <) (number 2) (getProperty (singleton en.ingredient) (string !type))))
Wie lange ist die insgesamt Kochzeit des Rezeptes	 (listValue (aggregate (string sum) (getProperty (getProperty (singleton en.recipe) (string !type)) (string cooking_time))))
Gibt es ein Rezept welches Milch und Milch benötigt	 (listValue (filter (filter (getProperty (singleton en.recipe) (string !type)) (string requires) (string =) en.ingredient.milk) (string requires) (string =) en.ingredient.milk))
Welches Rezept ist ohne Milch	 (listValue (filter (getProperty (singleton en.recipe) (string !type)) (string requires) (string !=) en.ingredient.milk))
Welches Rezept gibt es für mittags	 (listValue (filter (filter (getProperty (singleton en.recipe) (string !type)) (string meal) (string =) en.meal.lunch) (string meal) (string =) en.meal.lunch))
Wie lange dauert die Kochzeit des Puddings laut Rezept	 (listValue (filter (getProperty (singleton en.recipe) (string !type)) (string cooking_time) (string =) (getProperty en.recipe.rice_pudding (string cooking_time))))
Eisen Rezept das vor 2004 oder 2010 erfunden wurde	 (listValue (filter (getProperty (singleton en.recipe) (string !type)) (ensureNumericProperty (string posting_date)) (string <) (ensureNumericEntity (concat (date 2004 -1 -1) (date 2010 -1 -1)))))
Welches Rezept wurde früher als das für Reispudding gepostet	 (listValue (filter (getProperty (singleton en.recipe) (string !type)) (ensureNumericProperty (string posting_date)) (string <) (ensureNumericEntity (getProperty en.recipe.rice_pudding (string posting_date)))))
Ist es ein Rezept welches spätestens 2004 gepostet wurde	 (listValue (filter (getProperty (singleton en.recipe) (string !type)) (ensureNumericProperty (string posting_date)) (string <=) (ensureNumericEntity (date 2004 -1 -1))))
Welche Zutat des Rezeptes benötigt Milch zum zubereiten	 (listValue (filter (getProperty (singleton en.ingredient) (string !type)) (reverse (string requires)) (string =) (filter (getProperty (singleton en.recipe) (string !type)) (string requires) (string =) en.ingredient.milk)))
Welches Rezept wurde mindestens zur gleichen Zeit gepostet wie das für Reispudding	 (listValue (filter (getProperty (singleton en.recipe) (string !type)) (ensureNumericProperty (string posting_date)) (string >=) (ensureNumericEntity (getProperty en.recipe.rice_pudding (string posting_date)))))
Ist dies ein Mittagessen oder ein Abendessen	 (listValue (concat en.meal.lunch en.meal.dinner))
Welches Rezept ist schneller gekocht als die verobereitungszeit des Reispuddings	 (listValue (filter (getProperty (singleton en.recipe) (string !type)) (ensureNumericProperty (string cooking_time)) (string <) (ensureNumericEntity (getProperty en.recipe.rice_pudding (string preparation_time)))))
Welche Zutat benötigt man für die geringste Anzahl an Rezepten	 (listValue (countSuperlative (getProperty (singleton en.ingredient) (string !type)) (string min) (reverse (string requires)) (getProperty (singleton en.recipe) (string !type))))
Welche Rezepte wurden vor 2004 veröffentlicht	 (listValue (filter (getProperty (singleton en.recipe) (string !type)) (ensureNumericProperty (string posting_date)) (string <=) (ensureNumericEntity (date 2004 -1 -1))))
Welches Rezept hat eine längere Zubereitungszeit als Reispudding	 (listValue (filter (getProperty (singleton en.recipe) (string !type)) (ensureNumericProperty (string preparation_time)) (string >) (ensureNumericEntity (getProperty en.recipe.rice_pudding (string preparation_time)))))
welches Rezept dauert mindestens so lange wie die Zubereitung von Milchreis	 (listValue (filter (getProperty (singleton en.recipe) (string !type)) (ensureNumericProperty (string cooking_time)) (string >=) (ensureNumericEntity (getProperty en.recipe.rice_pudding (string cooking_time)))))
Welches Rezept hat die kürzeste Kochzeit	 (listValue (superlative (getProperty (singleton en.recipe) (string !type)) (string min) (ensureNumericProperty (string cooking_time))))
Welche Rezepte für Milchreich haben eine längere Vorbereitungszeit als die tatsächliche Kochzeit 	 (listValue (filter (getProperty (singleton en.recipe) (string !type)) (ensureNumericProperty (string preparation_time)) (string >) (ensureNumericEntity (getProperty en.recipe.rice_pudding (string cooking_time)))))
Welche Rezepte wurden spätestens 2004 oder 2010 veröffentlicht	 (listValue (filter (getProperty (singleton en.recipe) (string !type)) (ensureNumericProperty (string posting_date)) (string <=) (ensureNumericEntity (concat (date 2004 -1 -1) (date 2010 -1 -1)))))
Ist es ein Rezept das mehr als 2 Zutaten enthält	 (listValue (countComparative (getProperty (singleton en.recipe) (string !type)) (string requires) (string >) (number 2) (getProperty (singleton en.ingredient) (string !type))))
Für welche Mahlzeit wurde das Rezept 2004 veröffentlicht	 (listValue (filter (getProperty (singleton en.meal) (string !type)) (reverse (string meal)) (string =) (filter (getProperty (singleton en.recipe) (string !type)) (string posting_date) (string =) (date 2004 -1 -1))))
Welches Rezept wurde 2004 oder 2010 veröffentlicht	 (listValue (filter (getProperty (singleton en.recipe) (string !type)) (string posting_date) (string =) (concat (date 2004 -1 -1) (date 2010 -1 -1))))
Wie ist das Rezept für das Mittagessen das wir gerade genießen	 (listValue (filter (filter (getProperty (singleton en.recipe) (string !type)) (string meal) (string =) en.meal.lunch) (string meal) (string =) en.meal.lunch))
Welche Zutat benötigt man für ein Mittagsrezept	 (listValue (filter (getProperty (singleton en.ingredient) (string !type)) (reverse (string requires)) (string =) (filter (getProperty (singleton en.recipe) (string !type)) (string meal) (string =) en.meal.lunch)))
2004 oder 2010	 (listValue (concat (date 2004 -1 -1) (date 2010 -1 -1)))
Haben wir ein Rezept dessen Kochzeit der von Reispudding entspricht	 (listValue (filter (getProperty (singleton en.recipe) (string !type)) (ensureNumericProperty (string cooking_time)) (string >=) (ensureNumericEntity (getProperty en.recipe.rice_pudding (string cooking_time)))))
Ist es ein Rezept welches sich wie Reispudding vorbereiten lässt	 (listValue (filter (getProperty (singleton en.recipe) (string !type)) (string cuisine) (string =) (getProperty en.recipe.rice_pudding (string cuisine))))
Welche Rezepte benötigen Milch oder Spinat	 (listValue (filter (getProperty (singleton en.recipe) (string !type)) (string requires) (string =) (concat en.ingredient.milk en.ingredient.spinach)))
Welches Rezept wurde als letztes veröffentlicht	 (listValue (superlative (getProperty (singleton en.recipe) (string !type)) (string min) (ensureNumericProperty (string posting_date))))
Wie lang beträgt die gesamte Vorbereitungszeit für das Rezept	 (listValue (aggregate (string sum) (getProperty (getProperty (singleton en.recipe) (string !type)) (string preparation_time))))
Welches Rezept reict für mindestens zwei Essen	 (listValue (countComparative (getProperty (singleton en.recipe) (string !type)) (string meal) (string >=) (number 2) (getProperty (singleton en.meal) (string !type))))
Welches Rezept reicht fuer die meisten Mahlzeiten	 (listValue (countSuperlative (getProperty (singleton en.recipe) (string !type)) (string max) (string meal) (getProperty (singleton en.meal) (string !type))))
Welches Rezept hat höchstens die selbe Zubereitungszeit wie die Kochzeit von Milchreis	 (listValue (filter (getProperty (singleton en.recipe) (string !type)) (ensureNumericProperty (string preparation_time)) (string <=) (ensureNumericEntity (getProperty en.recipe.rice_pudding (string cooking_time)))))
Welches Rezept wurde nach 2004 hochgeladen	 (listValue (filter (getProperty (singleton en.recipe) (string !type)) (ensureNumericProperty (string posting_date)) (string >) (ensureNumericEntity (date 2004 -1 -1))))
Wie viele Zutaten werden benötigt	 (listValue (call .size (getProperty (singleton en.ingredient) (string !type))))
Rezept dass am wenigsten Zutaten benötigt	 (listValue (countSuperlative (getProperty (singleton en.recipe) (string !type)) (string min) (string requires) (getProperty (singleton en.ingredient) (string !type))))
Hast du ein Rezept für Milchreis	 (listValue (filter (getProperty (singleton en.recipe) (string !type)) (string meal) (string =) (filter (getProperty (singleton en.meal) (string !type)) (reverse (string meal)) (string =) en.recipe.rice_pudding)))
Ist bei dem Milchreisrezepte die Kochzeit überwiegend Vorbereitungszeit	 (listValue (filter (getProperty (singleton en.recipe) (string !type)) (ensureNumericProperty (string cooking_time)) (string <=) (ensureNumericEntity (getProperty en.recipe.rice_pudding (string preparation_time)))))
Was ist ein Rezept das in weniger als zwei Küchen gelistet ist	 (listValue (countComparative (getProperty (singleton en.recipe) (string !type)) (string cuisine) (string <) (number 2)))
Wurde das Rezept vor 2004 bzw. 2010 gepostet	 (listValue (filter (getProperty (singleton en.recipe) (string !type)) (ensureNumericProperty (string posting_date)) (string <) (ensureNumericEntity (concat (date 2004 -1 -1) (date 2010 -1 -1)))))
Wird diese Zutat für Milchreis oder Quiche benötigt	 (listValue (filter (getProperty (singleton en.ingredient) (string !type)) (reverse (string requires)) (string =) (concat en.recipe.rice_pudding en.recipe.quiche)))
Ist es ein Rezept welches eine Vorbereitungszeit mindestens so lange wie Reispudding hat	 (listValue (filter (getProperty (singleton en.recipe) (string !type)) (ensureNumericProperty (string preparation_time)) (string >=) (ensureNumericEntity (getProperty en.recipe.rice_pudding (string preparation_time)))))
Welches Rezept hat eine kürzere Vorbereitungszeit als Reispudding	 (listValue (filter (getProperty (singleton en.recipe) (string !type)) (ensureNumericProperty (string preparation_time)) (string <) (ensureNumericEntity (getProperty en.recipe.rice_pudding (string preparation_time)))))
Welche Rezepte gibt es von 2004 oder von 2010	 (listValue (concat (date 2004 -1 -1) (date 2010 -1 -1)))
Für wieviel Mahlzeiten reicht das Rezept 	 (listValue (countSuperlative (getProperty (singleton en.recipe) (string !type)) (string max) (string meal) (getProperty (singleton en.meal) (string !type))))
Welches Rezept hat mehr als zwei Kocharten	 (listValue (countComparative (getProperty (singleton en.recipe) (string !type)) (string cuisine) (string >) (number 2)))
Was dauert länger Die Vorbereitungszeit oder die Kochzeit	 (listValue (filter (getProperty (singleton en.recipe) (string !type)) (ensureNumericProperty (string preparation_time)) (string >) (ensureNumericEntity (getProperty en.recipe.rice_pudding (string cooking_time)))))
Kennen Sie ein Rezept für welches man zwei Zutaten benötigt	 (listValue (countComparative (getProperty (singleton en.recipe) (string !type)) (string requires) (string =) (number 2) (getProperty (singleton en.ingredient) (string !type))))
Welches Rezept hat höchstens zwei Cuisine	 (listValue (countComparative (getProperty (singleton en.recipe) (string !type)) (string cuisine) (string <=) (number 2)))
Kennst du ein Rezept für ein Mittagessen 	 (listValue (filter (getProperty (singleton en.recipe) (string !type)) (string meal) (string =) en.meal.lunch))
Muss ich das Rezept in zwei Küchen vorbereiten	 (listValue (countComparative (getProperty (singleton en.recipe) (string !type)) (string cuisine) (string =) (number 2)))
Was brauche ich nicht für Milchreis	 (listValue (filter (getProperty (singleton en.ingredient) (string !type)) (reverse (string requires)) (string !=) en.recipe.rice_pudding))
Welches Gericht braucht mindestens zwei Zutaten	 (listValue (countComparative (getProperty (singleton en.recipe) (string !type)) (string requires) (string >=) (number 2) (getProperty (singleton en.ingredient) (string !type))))
Welches Rezept machen wir zum Mittagessen	 (listValue (filter (getProperty (singleton en.meal) (string !type)) (reverse (string meal)) (string =) (filter (getProperty (singleton en.recipe) (string !type)) (string meal) (string =) en.meal.lunch)))
Welches Rezept benötigt die meisten Zutaten	 (listValue (countSuperlative (getProperty (singleton en.recipe) (string !type)) (string max) (string requires) (getProperty (singleton en.ingredient) (string !type))))
Welches Rezept benötigt die meisten Zutaten	 (listValue (countSuperlative (getProperty (singleton en.recipe) (string !type)) (string max) (string requires) (getProperty (singleton en.ingredient) (string !type))))
Hast du das beste Rezept 	 (listValue (countSuperlative (getProperty (singleton en.recipe) (string !type)) (string max) (string cuisine)))
Welche Zutat wird für Milchreis oder Quiche benötigt	 (listValue (filter (getProperty (singleton en.ingredient) (string !type)) (reverse (string requires)) (string =) (concat en.recipe.rice_pudding en.recipe.quiche)))
Welches Rezept eignet sich für den Mittagstisch	 (listValue (filter (getProperty (singleton en.meal) (string !type)) (reverse (string meal)) (string =) (filter (getProperty (singleton en.recipe) (string !type)) (string meal) (string =) en.meal.lunch)))
Wie lange ist die vollständige Kochzeit des Rezepts	 (listValue (aggregate (string sum) (getProperty (getProperty (singleton en.recipe) (string !type)) (string cooking_time))))
Welches Rezept für Reispudding hat mindestens die gleiche Zubereitungszeit wie die Kochzeit	 (listValue (filter (getProperty (singleton en.recipe) (string !type)) (ensureNumericProperty (string preparation_time)) (string >=) (ensureNumericEntity (getProperty en.recipe.rice_pudding (string cooking_time)))))
Welche Zutaten benötigt Milchreis	 (listValue (filter (filter (getProperty (singleton en.ingredient) (string !type)) (reverse (string requires)) (string =) en.recipe.rice_pudding) (reverse (string requires)) (string =) en.recipe.rice_pudding))
Welches Rezept ist als Hauptspeise zu Mittag geeignet	 (listValue (filter (getProperty (singleton en.meal) (string !type)) (reverse (string meal)) (string =) (filter (getProperty (singleton en.recipe) (string !type)) (string meal) (string =) en.meal.lunch)))
Welche Zutaten kommen am häufigsten in den Rezepten vor	 (listValue (countSuperlative (getProperty (singleton en.ingredient) (string !type)) (string max) (reverse (string requires)) (getProperty (singleton en.recipe) (string !type))))
Welche Rezepte enthalten Milch und wurden 2004 veröffentlicht	 (listValue (filter (filter (getProperty (singleton en.recipe) (string !type)) (string requires) (string =) en.ingredient.milk) (string posting_date) (string =) (date 2004 -1 -1)))
Für welches Rezept das 2004 gepostet wurde benötigt man Milch	 (listValue (filter (filter (getProperty (singleton en.recipe) (string !type)) (string requires) (string =) en.ingredient.milk) (string posting_date) (string =) (date 2004 -1 -1)))
Für welche Mahlzeiten wurden 2004 Rezepte veröffentlicht	 (listValue (filter (getProperty (singleton en.meal) (string !type)) (reverse (string meal)) (string =) (filter (getProperty (singleton en.recipe) (string !type)) (string posting_date) (string =) (date 2004 -1 -1))))
Hast du ein Rezept für ein Essen für zwei Personen	 (listValue (countComparative (getProperty (singleton en.recipe) (string !type)) (string meal) (string <=) (number 2) (getProperty (singleton en.meal) (string !type))))
Für welches Rezept für Reispudding benötigt man Reispuddings	 (listValue (filter (filter (getProperty (singleton en.ingredient) (string !type)) (reverse (string requires)) (string =) en.recipe.rice_pudding) (reverse (string requires)) (string =) en.recipe.rice_pudding))
Mit welchem Rezept kann man Reispudding kochen	 (listValue (filter (getProperty (singleton en.recipe) (string !type)) (string meal) (string =) (filter (getProperty (singleton en.meal) (string !type)) (reverse (string meal)) (string =) en.recipe.rice_pudding)))
Wurde das Rezept höchstens 2004 gepostet	 (listValue (filter (getProperty (singleton en.recipe) (string !type)) (ensureNumericProperty (string posting_date)) (string >=) (ensureNumericEntity (date 2004 -1 -1))))
Welches Rezept wurde vor dem Rezept für Reispudding veröffentlicht	 (listValue (filter (getProperty (singleton en.recipe) (string !type)) (ensureNumericProperty (string posting_date)) (string <) (ensureNumericEntity (getProperty en.recipe.rice_pudding (string posting_date)))))
Welches Rezept benötigt mindestens die gleiche Zubereitungszeit wie Reispudding	 (listValue (filter (getProperty (singleton en.recipe) (string !type)) (ensureNumericProperty (string preparation_time)) (string >=) (ensureNumericEntity (getProperty en.recipe.rice_pudding (string preparation_time)))))
Hast du ein Rezept von der Zeit vor 2004	 (listValue (filter (getProperty (singleton en.recipe) (string !type)) (ensureNumericProperty (string posting_date)) (string <) (ensureNumericEntity (date 2004 -1 -1))))
Wie lange dauert die Zubereitung des Rezepts durchschnittlich	 (listValue (aggregate (string avg) (getProperty (getProperty (singleton en.recipe) (string !type)) (string preparation_time))))
Welches Rezept ist für sowohl für mittags als auch für abends	 (listValue (filter (getProperty (singleton en.recipe) (string !type)) (string meal) (string =) (concat en.meal.lunch en.meal.dinner)))
Welche Zutat wird von der geringsten Anzahl von Rezepten benötigt	 (listValue (countSuperlative (getProperty (singleton en.ingredient) (string !type)) (string min) (reverse (string requires)) (getProperty (singleton en.recipe) (string !type))))
Hat das Rezept eine längere Gaszeit als Reispudding	 (listValue (filter (getProperty (singleton en.recipe) (string !type)) (ensureNumericProperty (string cooking_time)) (string >) (ensureNumericEntity (getProperty en.recipe.rice_pudding (string cooking_time)))))
Welche Zutat wird am häufigsten in Rezepten verwendet	 (listValue (countSuperlative (getProperty (singleton en.ingredient) (string !type)) (string max) (reverse (string requires)) (getProperty (singleton en.recipe) (string !type))))
Welche Zutat wird von den wenigsten Rezepten genutzt	 (listValue (countSuperlative (getProperty (singleton en.ingredient) (string !type)) (string min) (reverse (string requires)) (getProperty (singleton en.recipe) (string !type))))
Welches Rezept liefert die maximale Anzahl an Mahlzeiten	 (listValue (countSuperlative (getProperty (singleton en.recipe) (string !type)) (string max) (string meal) (getProperty (singleton en.meal) (string !type))))
Welches Rezept wurde mindestens im Jahr 2004 oder 2010 gepostet	 (listValue (filter (getProperty (singleton en.recipe) (string !type)) (ensureNumericProperty (string posting_date)) (string >=) (ensureNumericEntity (concat (date 2004 -1 -1) (date 2010 -1 -1)))))
Für welches Gericht gibt es die wenigsten Rezepte	 (listValue (countSuperlative (getProperty (singleton en.meal) (string !type)) (string min) (reverse (string meal)) (getProperty (singleton en.recipe) (string !type))))
Wie ist die durchschnittliche Kochzeit des Rezepts	 (listValue (aggregate (string avg) (getProperty (getProperty (singleton en.recipe) (string !type)) (string cooking_time))))
Hast du einen Versandbeleg der nicht von 2004 ist	 (listValue (filter (getProperty (singleton en.recipe) (string !type)) (string posting_date) (string !=) (date 2004 -1 -1)))
Welches Rezept wurde am gleichen Tag wie das Rezept für den Milchreis veröffentlicht	 (listValue (filter (getProperty (singleton en.recipe) (string !type)) (string posting_date) (string =) (getProperty en.recipe.rice_pudding (string posting_date))))
Welche Zutat wird für zwei Rezepte benötigt	 (listValue (countComparative (getProperty (singleton en.ingredient) (string !type)) (reverse (string requires)) (string =) (number 2) (getProperty (singleton en.recipe) (string !type))))
Welches Rezept gibt es deren Kochzeit kürzer als die die man für Reispudding braucht	 (listValue (filter (getProperty (singleton en.recipe) (string !type)) (ensureNumericProperty (string cooking_time)) (string <) (ensureNumericEntity (getProperty en.recipe.rice_pudding (string cooking_time)))))
Was ist die Hauptzutat für die meisten Rezepte 	 (listValue (countSuperlative (getProperty (singleton en.ingredient) (string !type)) (string max) (reverse (string requires)) (getProperty (singleton en.recipe) (string !type))))
Ich suche das Rezept welches Milch und benötigt	 (listValue (filter (filter (getProperty (singleton en.recipe) (string !type)) (string requires) (string =) en.ingredient.milk) (string requires) (string =) en.ingredient.milk))
Welche Zutat wird für Reispudding benötigt	 (listValue (filter (filter (getProperty (singleton en.ingredient) (string !type)) (reverse (string requires)) (string =) en.recipe.rice_pudding) (reverse (string requires)) (string =) en.recipe.rice_pudding))
Wieviel Essen werden gebraucht	 (listValue (call .size (getProperty (singleton en.meal) (string !type))))
Welches Rezept beinhaltet zwei Kochkünste	 (listValue (countComparative (getProperty (singleton en.recipe) (string !type)) (string cuisine) (string =) (number 2)))
Welches Rezept benötigt zwei Zutaten	 (listValue (countComparative (getProperty (singleton en.recipe) (string !type)) (string requires) (string =) (number 2) (getProperty (singleton en.ingredient) (string !type))))
Welches Kochrezept hat eine längere Zubereitungsdauer als Reispudding	 (listValue (filter (getProperty (singleton en.recipe) (string !type)) (ensureNumericProperty (string preparation_time)) (string >) (ensureNumericEntity (getProperty en.recipe.rice_pudding (string preparation_time)))))
Welches Rezept braucht mindestens zwei Zutaten	 (listValue (countComparative (getProperty (singleton en.recipe) (string !type)) (string requires) (string >=) (number 2) (getProperty (singleton en.ingredient) (string !type))))
Welches Rezept hat eine längere Vorbereitungszeit als die Zubereitungszeit von Reispudding	 (listValue (filter (getProperty (singleton en.recipe) (string !type)) (ensureNumericProperty (string cooking_time)) (string >) (ensureNumericEntity (getProperty en.recipe.rice_pudding (string preparation_time)))))
Kennst du ein Rezept von 2004 vor 2010	 (listValue (filter (getProperty (singleton en.recipe) (string !type)) (ensureNumericProperty (string posting_date)) (string <=) (ensureNumericEntity (concat (date 2004 -1 -1) (date 2010 -1 -1)))))
Welche Zutaten werden von mindestens zwei Rezepten benötigt	 (listValue (countComparative (getProperty (singleton en.ingredient) (string !type)) (reverse (string requires)) (string >=) (number 2) (getProperty (singleton en.recipe) (string !type))))
Welche Rezept Veröffentlichung ist länger her als die von Reispudding	 (listValue (filter (getProperty (singleton en.recipe) (string !type)) (ensureNumericProperty (string posting_date)) (string >) (ensureNumericEntity (getProperty en.recipe.rice_pudding (string posting_date)))))
Welche Zutat benötigt man für zwei Rezepte	 (listValue (countComparative (getProperty (singleton en.ingredient) (string !type)) (reverse (string requires)) (string =) (number 2) (getProperty (singleton en.recipe) (string !type))))
Welche Rezepte sind ohne Milch	 (listValue (filter (getProperty (singleton en.recipe) (string !type)) (string requires) (string !=) en.ingredient.milk))
Welches Rezept wurde vor 2004 oder 2010 gepostet	 (listValue (filter (getProperty (singleton en.recipe) (string !type)) (ensureNumericProperty (string posting_date)) (string <) (ensureNumericEntity (concat (date 2004 -1 -1) (date 2010 -1 -1)))))
Was ist ein Rezept für Mittagessen das Milch benötigt	 (listValue (filter (filter (getProperty (singleton en.recipe) (string !type)) (string requires) (string =) en.ingredient.milk) (string meal) (string =) en.meal.lunch))
In welchem Rezept entspricht die Kochzeit der Zubereitungszeit für den Reispudding	 (listValue (filter (getProperty (singleton en.recipe) (string !type)) (string cooking_time) (string =) (getProperty en.recipe.rice_pudding (string preparation_time))))
Welches Rezept wurde nach 2004 veröffentlicht	 (listValue (filter (getProperty (singleton en.recipe) (string !type)) (ensureNumericProperty (string posting_date)) (string >) (ensureNumericEntity (date 2004 -1 -1))))
Welches Rezept für das Mittags oder Abendessen	 (listValue (filter (getProperty (singleton en.recipe) (string !type)) (string meal) (string =) (concat en.meal.lunch en.meal.dinner)))
Welche Zutat ist fuer das Rezept erforderlich welches 2004 eingestellt wurde	 (listValue (filter (getProperty (singleton en.ingredient) (string !type)) (reverse (string requires)) (string =) (filter (getProperty (singleton en.recipe) (string !type)) (string posting_date) (string =) (date 2004 -1 -1))))
Welche Rezepte wurden 2004 eingereicht und sind als Mittagessen gedacht	 (listValue (filter (filter (getProperty (singleton en.recipe) (string !type)) (string meal) (string =) en.meal.lunch) (string posting_date) (string =) (date 2004 -1 -1)))
Kommst du zum Mittag oder Abendessen	 (listValue (concat en.meal.lunch en.meal.dinner))
Welches Rezept hat mindestens die selbe Kochzeit wie die des Milchreises	 (listValue (filter (getProperty (singleton en.recipe) (string !type)) (ensureNumericProperty (string cooking_time)) (string >=) (ensureNumericEntity (getProperty en.recipe.rice_pudding (string cooking_time)))))
Welches Rezept wurde 2004 eingestellt und wird zu Mittag gegessen	 (listValue (filter (filter (getProperty (singleton en.recipe) (string !type)) (string posting_date) (string =) (date 2004 -1 -1)) (string meal) (string =) en.meal.lunch))
Ist das Rezept fürs Mittagessen geeignet	 (listValue (filter (filter (getProperty (singleton en.recipe) (string !type)) (string meal) (string =) en.meal.lunch) (string meal) (string =) en.meal.lunch))
Braucht diese Rezept weniger als zwei Zutaten	 (listValue (countComparative (getProperty (singleton en.recipe) (string !type)) (string requires) (string <) (number 2) (getProperty (singleton en.ingredient) (string !type))))
Was ist das Rezept von 2004 welches fuer Mittag ist	 (listValue (filter (filter (getProperty (singleton en.recipe) (string !type)) (string posting_date) (string =) (date 2004 -1 -1)) (string meal) (string =) en.meal.lunch))
Für welche Mahlzeit eignet sich Reispudding	 (listValue (filter (getProperty (singleton en.meal) (string !type)) (reverse (string meal)) (string =) en.recipe.rice_pudding))
Hast du ein Rezept was maximal die gleiche Zeit dauert wie die Zubereitung von Milchreis	 (listValue (filter (getProperty (singleton en.recipe) (string !type)) (ensureNumericProperty (string preparation_time)) (string <=) (ensureNumericEntity (getProperty en.recipe.rice_pudding (string preparation_time)))))
Für welches Gericht gibt es die wenigsten Rezepte	 (listValue (countSuperlative (getProperty (singleton en.meal) (string !type)) (string min) (reverse (string meal)) (getProperty (singleton en.recipe) (string !type))))
Welche Rezepte haben höchstens zwei kulinarische Hintergründe	 (listValue (countComparative (getProperty (singleton en.recipe) (string !type)) (string cuisine) (string <=) (number 2)))
Welche Zutat benötigt man für Reispudding oder Quiche	 (listValue (filter (getProperty (singleton en.ingredient) (string !type)) (reverse (string requires)) (string =) (concat en.recipe.rice_pudding en.recipe.quiche)))
Wie lange muss man Milchreis kochen	 (listValue (getProperty en.recipe.rice_pudding (string cooking_time)))
Welches Rezept benötigt die geringste Menge der Zutat	 (listValue (countSuperlative (getProperty (singleton en.recipe) (string !type)) (string min) (string requires) (getProperty (singleton en.ingredient) (string !type))))
Wie viele Zutaten brauchen wir	 (listValue (call .size (getProperty (singleton en.ingredient) (string !type))))
Welches Rezept hat eine kürzere Kochzeit als Reispudding	 (listValue (filter (getProperty (singleton en.recipe) (string !type)) (ensureNumericProperty (string cooking_time)) (string <) (ensureNumericEntity (getProperty en.recipe.rice_pudding (string cooking_time)))))
Für welches Mahl für zwei Leute ist dieses Rezept	 (listValue (countComparative (getProperty (singleton en.meal) (string !type)) (reverse (string meal)) (string =) (number 2) (getProperty (singleton en.recipe) (string !type))))
Welches Rezept ist schneller zubereitet als Milchreis	 (listValue (filter (getProperty (singleton en.recipe) (string !type)) (ensureNumericProperty (string cooking_time)) (string <) (ensureNumericEntity (getProperty en.recipe.rice_pudding (string preparation_time)))))
Was ist eine Zutat die für zwei Rezepte benötigt wird	 (listValue (countComparative (getProperty (singleton en.ingredient) (string !type)) (reverse (string requires)) (string =) (number 2) (getProperty (singleton en.recipe) (string !type))))
Das Rezept welches 2004 oder 2010 gepostet wurde	 (listValue (filter (getProperty (singleton en.recipe) (string !type)) (ensureNumericProperty (string posting_date)) (string >=) (ensureNumericEntity (concat (date 2004 -1 -1) (date 2010 -1 -1)))))
Welches Rezept hat das kleinste Buchungsdatum	 (listValue (superlative (getProperty (singleton en.recipe) (string !type)) (string min) (ensureNumericProperty (string posting_date))))
Welches Rezept dauert genau solange wie Milchreis	 (listValue (filter (getProperty (singleton en.recipe) (string !type)) (string preparation_time) (string =) (getProperty en.recipe.rice_pudding (string preparation_time))))
Welches Rezept hat die laengste Zubereitungszeit	 (listValue (superlative (getProperty (singleton en.recipe) (string !type)) (string max) (ensureNumericProperty (string cooking_time))))
Wie ist die Nummer dieses Gerichtes	 (listValue (call .size (getProperty (singleton en.meal) (string !type))))
Welches Rezept das vor dem Rezept für Reispudding gepostet wurde	 (listValue (filter (getProperty (singleton en.recipe) (string !type)) (ensureNumericProperty (string posting_date)) (string <=) (ensureNumericEntity (getProperty en.recipe.rice_pudding (string posting_date)))))
Welches Rezept benötigt mindestens zwei Zutaten	 (listValue (countComparative (getProperty (singleton en.recipe) (string !type)) (string requires) (string <=) (number 2) (getProperty (singleton en.ingredient) (string !type))))
Ist das Rezept 2004 veröffentlicht worden und was braucht man an Zutaten	 (listValue (filter (getProperty (singleton en.ingredient) (string !type)) (reverse (string requires)) (string =) (filter (getProperty (singleton en.recipe) (string !type)) (string posting_date) (string =) (date 2004 -1 -1))))
Welche Zutat kann in mindestens zwei Rezepten verwendet werden	 (listValue (countComparative (getProperty (singleton en.ingredient) (string !type)) (reverse (string requires)) (string >=) (number 2) (getProperty (singleton en.recipe) (string !type))))
Welches Rezept wurde vor Reispudding veröffentlicht	 (listValue (filter (getProperty (singleton en.recipe) (string !type)) (ensureNumericProperty (string posting_date)) (string <) (ensureNumericEntity (getProperty en.recipe.rice_pudding (string posting_date)))))
2004 oder 2010	 (listValue (concat (date 2004 -1 -1) (date 2010 -1 -1)))
Welches Rezept wird in den meisten Kulturen gekocht	 (listValue (countSuperlative (getProperty (singleton en.recipe) (string !type)) (string max) (string cuisine)))
Welches Rezept eignet sich für mindestens zwei Mahlzeiten	 (listValue (countComparative (getProperty (singleton en.recipe) (string !type)) (string meal) (string >=) (number 2) (getProperty (singleton en.meal) (string !type))))
Hat das Rezept eine Zubereitungszeit welcher der Kochzeit von Reispudding entspricht	 (listValue (filter (getProperty (singleton en.recipe) (string !type)) (ensureNumericProperty (string preparation_time)) (string <=) (ensureNumericEntity (getProperty en.recipe.rice_pudding (string cooking_time)))))
Hat das Rezept eine längere Kochzeit als die Zubereitungszeit von Reispudding	 (listValue (filter (getProperty (singleton en.recipe) (string !type)) (ensureNumericProperty (string cooking_time)) (string >) (ensureNumericEntity (getProperty en.recipe.rice_pudding (string preparation_time)))))
eine Zutat die für Reispudding benötigt wird	 (listValue (filter (getProperty (singleton en.ingredient) (string !type)) (reverse (string requires)) (string =) en.recipe.rice_pudding))
Welches Rezept hat Ursprung in mindestens zwei Kulturen	 (listValue (countComparative (getProperty (singleton en.recipe) (string !type)) (string cuisine) (string <=) (number 2)))
Für welches Gericht gibt es die wenigsten Rezepte	 (listValue (countSuperlative (getProperty (singleton en.recipe) (string !type)) (string min) (string meal) (getProperty (singleton en.meal) (string !type))))
Welches Gericht wurde am gleichen Tag gepostet wie der Reispudding	 (listValue (filter (getProperty (singleton en.recipe) (string !type)) (string posting_date) (string =) (getProperty en.recipe.rice_pudding (string posting_date))))
Ist das ein Rezept was Milch braucht und für das Mittagessen ist	 (listValue (filter (filter (getProperty (singleton en.recipe) (string !type)) (string requires) (string =) en.ingredient.milk) (string meal) (string =) en.meal.lunch))
Haben wir ein Rezept das für mindestens zwei Mahlzeiten reicht	 (listValue (countComparative (getProperty (singleton en.recipe) (string !type)) (string meal) (string >=) (number 2) (getProperty (singleton en.meal) (string !type))))
Was ist die Zutat in dem einen Rezept das Milch benoetigt	 (listValue (filter (getProperty (singleton en.ingredient) (string !type)) (reverse (string requires)) (string =) (filter (getProperty (singleton en.recipe) (string !type)) (string requires) (string =) en.ingredient.milk)))
Welche Rezept hat maximal zwei Küchen	 (listValue (countComparative (getProperty (singleton en.recipe) (string !type)) (string cuisine) (string <=) (number 2)))
Welches Rezept benötigt Milch und wurde 2004 veröffentlicht	 (listValue (filter (filter (getProperty (singleton en.recipe) (string !type)) (string requires) (string =) en.ingredient.milk) (string posting_date) (string =) (date 2004 -1 -1)))
Welches Rezept wurde als erstes veröffentlicht	 (listValue (superlative (getProperty (singleton en.recipe) (string !type)) (string max) (ensureNumericProperty (string posting_date))))
Welches Rezept wurde nach 2004 oder 2010 veröffentlicht	 (listValue (filter (getProperty (singleton en.recipe) (string !type)) (ensureNumericProperty (string posting_date)) (string >) (ensureNumericEntity (concat (date 2004 -1 -1) (date 2010 -1 -1)))))
Wie hoch ist die insgesamt Zubereitungszeit des Rezeptes	 (listValue (aggregate (string sum) (getProperty (getProperty (singleton en.recipe) (string !type)) (string preparation_time))))
Wann wurde das Milchreisrezepte veröffentlicht	 (listValue (getProperty en.recipe.rice_pudding (string posting_date)))
Ist es ein Essen für das es mehr als 2 Rezepte gibt	 (listValue (countComparative (getProperty (singleton en.meal) (string !type)) (reverse (string meal)) (string >=) (number 2) (getProperty (singleton en.recipe) (string !type))))
Welches Rezept wurde 2004 oder 2010 gepostet	 (listValue (filter (getProperty (singleton en.recipe) (string !type)) (string posting_date) (string =) (concat (date 2004 -1 -1) (date 2010 -1 -1))))
Für welche Mahlzeit gibt es am meisten Rezepte	 (listValue (countSuperlative (getProperty (singleton en.meal) (string !type)) (string max) (reverse (string meal)) (getProperty (singleton en.recipe) (string !type))))
Welches Rezepte sind für 2 Personen	 (listValue (countComparative (getProperty (singleton en.recipe) (string !type)) (string meal) (string =) (number 2) (getProperty (singleton en.meal) (string !type))))
Kannst du mir ein Essen sagen für das ich möglichst wenig Zutaten brauche	 (listValue (countSuperlative (getProperty (singleton en.meal) (string !type)) (string min) (reverse (string meal)) (getProperty (singleton en.recipe) (string !type))))
Veröffenltichkeitsdatum von Reispudding	 (listValue (getProperty en.recipe.rice_pudding (string posting_date)))
Zu welcher Mahlzeit wird Reispudding nicht gegessen	 (listValue (filter (getProperty (singleton en.meal) (string !type)) (reverse (string meal)) (string !=) en.recipe.rice_pudding))
Welches Rezept ist für höchstens zwei geeignet	 (listValue (countComparative (getProperty (singleton en.recipe) (string !type)) (string meal) (string <=) (number 2) (getProperty (singleton en.meal) (string !type))))
Welches Rezept hat eine längere Zubereitungszeit als Milchreis	 (listValue (filter (getProperty (singleton en.recipe) (string !type)) (ensureNumericProperty (string preparation_time)) (string >) (ensureNumericEntity (getProperty en.recipe.rice_pudding (string preparation_time)))))
Welches Rezept ist am schnellsten zubereitet	 (listValue (superlative (getProperty (singleton en.recipe) (string !type)) (string min) (ensureNumericProperty (string cooking_time))))
Für welche Mahlzeit sind Reispudding und Quiche gedacht	 (listValue (filter (getProperty (singleton en.meal) (string !type)) (reverse (string meal)) (string =) (concat en.recipe.rice_pudding en.recipe.quiche)))
Welches Rezept benötigt höchstens zwei Zutaten	 (listValue (countComparative (getProperty (singleton en.recipe) (string !type)) (string requires) (string <=) (number 2) (getProperty (singleton en.ingredient) (string !type))))
Welches Rezept wurde spätestens am selben Tag wie das Rezept für Reispudding veröffentlicht	 (listValue (filter (getProperty (singleton en.recipe) (string !type)) (ensureNumericProperty (string posting_date)) (string <=) (ensureNumericEntity (getProperty en.recipe.rice_pudding (string posting_date)))))
Welche Rezepte enthalten Milch	 (listValue (filter (filter (getProperty (singleton en.recipe) (string !type)) (string requires) (string =) en.ingredient.milk) (string requires) (string =) en.ingredient.milk))
Welches Rezept findet sich in weniger als zwei Küchen	 (listValue (countComparative (getProperty (singleton en.recipe) (string !type)) (string cuisine) (string <) (number 2)))
Welches Rezept hat die meisten Portionen	 (listValue (countSuperlative (getProperty (singleton en.recipe) (string !type)) (string max) (string meal) (getProperty (singleton en.meal) (string !type))))
Welche Rezepte haben eine längere Zubereitungszeit als Milchreis	 (listValue (filter (getProperty (singleton en.recipe) (string !type)) (ensureNumericProperty (string cooking_time)) (string >) (ensureNumericEntity (getProperty en.recipe.rice_pudding (string cooking_time)))))
Welche Milchreisrezepte gibt es die die gleiche Koch- und Vorbereitungszeit benötigen	 (listValue (filter (getProperty (singleton en.recipe) (string !type)) (string preparation_time) (string =) (getProperty en.recipe.rice_pudding (string cooking_time))))
Welche Rezepte wurden 2004 oder später veröffentlicht	 (listValue (filter (getProperty (singleton en.recipe) (string !type)) (ensureNumericProperty (string posting_date)) (string >=) (ensureNumericEntity (date 2004 -1 -1))))
Welches Rezept braucht man für weniger als zwei Mahlzeiten	 (listValue (countComparative (getProperty (singleton en.recipe) (string !type)) (string meal) (string <) (number 2) (getProperty (singleton en.meal) (string !type))))
Welches Rezept hat eine kürzere Zubereitungszeit als Reispudding	 (listValue (filter (getProperty (singleton en.recipe) (string !type)) (ensureNumericProperty (string preparation_time)) (string <) (ensureNumericEntity (getProperty en.recipe.rice_pudding (string preparation_time)))))
Welches Rezept ist kein Mittagessen	 (listValue (filter (getProperty (singleton en.recipe) (string !type)) (string meal) (string !=) en.meal.lunch))
Für welches Rezept ist die Vorbereitungszeit höchstens so lange wie die Kochzeit von Reispudding	 (listValue (filter (getProperty (singleton en.recipe) (string !type)) (ensureNumericProperty (string preparation_time)) (string <=) (ensureNumericEntity (getProperty en.recipe.rice_pudding (string cooking_time)))))
Welches Rezept hat die längste Vorbereitungszeit	 (listValue (superlative (getProperty (singleton en.recipe) (string !type)) (string max) (ensureNumericProperty (string preparation_time))))
Welche Rezepte benötigen Milch und wurden 2004 eingestellt	 (listValue (filter (filter (getProperty (singleton en.recipe) (string !type)) (string requires) (string =) en.ingredient.milk) (string posting_date) (string =) (date 2004 -1 -1)))
Sollen ich es zum Mittag oder zum Abendessen kochen	 (listValue (concat en.meal.lunch en.meal.dinner))
Eine Zutat die für Reispudding benötigt wird	 (listValue (filter (filter (getProperty (singleton en.ingredient) (string !type)) (reverse (string requires)) (string =) en.recipe.rice_pudding) (reverse (string requires)) (string =) en.recipe.rice_pudding))
Wie hoch ist die durchschnittliche Kochzeit des Rezeptes	 (listValue (aggregate (string avg) (getProperty (getProperty (singleton en.recipe) (string !type)) (string cooking_time))))
Was ist ein Rezept für das man mindestens zwei Zutaten braucht	 (listValue (countComparative (getProperty (singleton en.recipe) (string !type)) (string requires) (string >=) (number 2) (getProperty (singleton en.ingredient) (string !type))))
Welches Rezept wurde 2014 veröffentlicht	 (listValue (filter (getProperty (singleton en.recipe) (string !type)) (string posting_date) (string =) (date 2004 -1 -1)))
Kennst du ein Rezept das Milch braucht	 (listValue (filter (getProperty (singleton en.recipe) (string !type)) (string requires) (string =) en.ingredient.milk))
Welches Rezept hat dieselbe Zubereitungszeit wie Reispudding	 (listValue (filter (getProperty (singleton en.recipe) (string !type)) (string preparation_time) (string =) (getProperty en.recipe.rice_pudding (string preparation_time))))
Welches Rezept wurde als letztes veröffentlicht	 (listValue (superlative (getProperty (singleton en.recipe) (string !type)) (string min) (ensureNumericProperty (string posting_date))))
Kennst du ein Rezept das für weniger als zwei Mahlzeiten ist 	 (listValue (countComparative (getProperty (singleton en.recipe) (string !type)) (string meal) (string <) (number 2) (getProperty (singleton en.meal) (string !type))))
Aus welcher Kultur stammt Milchreis	 (listValue (getProperty en.recipe.rice_pudding (string cuisine)))
Gibt es Milch oder Spinat	 (listValue (concat en.ingredient.milk en.ingredient.spinach))
Welche Rezepte wurden später gepostet als Reispudding	 (listValue (filter (getProperty (singleton en.recipe) (string !type)) (ensureNumericProperty (string posting_date)) (string >) (ensureNumericEntity (getProperty en.recipe.rice_pudding (string posting_date)))))
Was ist ein Gericht dass weniger als zwei Herkunftsorte hat	 (listValue (countComparative (getProperty (singleton en.recipe) (string !type)) (string cuisine) (string <) (number 2)))
Welche Rezepte benötigen Milch	 (listValue (filter (getProperty (singleton en.recipe) (string !type)) (string requires) (string =) en.ingredient.milk))
Ein Rezept dass für mehr als zwei Gerichte ist	 (listValue (countComparative (getProperty (singleton en.recipe) (string !type)) (string meal) (string >) (number 2) (getProperty (singleton en.meal) (string !type))))
Milch oder Spinat	 (listValue (concat en.ingredient.milk en.ingredient.spinach))
Welches Rezept benötigen wir für die geringste Anzahl Gerichte	 (listValue (countSuperlative (getProperty (singleton en.recipe) (string !type)) (string min) (string meal) (getProperty (singleton en.meal) (string !type))))
Welches Rezept wurde 2004 veröffentlicht	 (listValue (filter (getProperty (singleton en.recipe) (string !type)) (string posting_date) (string =) (date 2004 -1 -1)))
Welches Rezept dauert am längsten	 (listValue (superlative (getProperty (singleton en.recipe) (string !type)) (string max) (ensureNumericProperty (string cooking_time))))
Für welches Fleisch gibt es die meisten Rezepte	 (listValue (countSuperlative (getProperty (singleton en.meal) (string !type)) (string max) (reverse (string meal)) (getProperty (singleton en.recipe) (string !type))))
Für welches Rezept braucht man mehr als zwei Zutaten	 (listValue (countComparative (getProperty (singleton en.recipe) (string !type)) (string requires) (string >) (number 2) (getProperty (singleton en.ingredient) (string !type))))
Moechten Sie Milchreis oder Quiche	 (listValue (concat en.recipe.rice_pudding en.recipe.quiche))
Welche Rezepte wurden vor 2004 online gestellt	 (listValue (filter (getProperty (singleton en.recipe) (string !type)) (ensureNumericProperty (string posting_date)) (string <) (ensureNumericEntity (date 2004 -1 -1))))
Welches Rezept basiert auf mindestens zwei Küchen	 (listValue (countComparative (getProperty (singleton en.recipe) (string !type)) (string cuisine) (string >=) (number 2)))
Welches Rezept beinhaltet weniger als zwei nationale Küchen	 (listValue (countComparative (getProperty (singleton en.recipe) (string !type)) (string cuisine) (string <) (number 2)))
Kennst du ein Rezept welches länger dauert als Milchreis	 (listValue (filter (getProperty (singleton en.recipe) (string !type)) (ensureNumericProperty (string cooking_time)) (string >) (ensureNumericEntity (getProperty en.recipe.rice_pudding (string cooking_time)))))
Wie lange dauert es durchschnittlich dieses Essen zu machen	 (listValue (aggregate (string avg) (getProperty (getProperty (singleton en.recipe) (string !type)) (string preparation_time))))
Für welche Mahlzeit wird Milchreis benötigt	 (listValue (filter (filter (getProperty (singleton en.meal) (string !type)) (reverse (string meal)) (string =) en.recipe.rice_pudding) (reverse (string meal)) (string =) en.recipe.rice_pudding))
Welches Rezept benötigt weniger als zwei Zutaten	 (listValue (countComparative (getProperty (singleton en.ingredient) (string !type)) (reverse (string requires)) (string <) (number 2) (getProperty (singleton en.recipe) (string !type))))
Welches Rezept braucht mehr als zwei Zutaten	 (listValue (countComparative (getProperty (singleton en.recipe) (string !type)) (string requires) (string >) (number 2) (getProperty (singleton en.ingredient) (string !type))))
Welche Rezept gehört zu den wenigstens regionalen Spezialitäten	 (listValue (countSuperlative (getProperty (singleton en.recipe) (string !type)) (string min) (string cuisine)))
Welches Rezept kann für mehrere Mahlzeiten verwendet werden	 (listValue (countSuperlative (getProperty (singleton en.recipe) (string !type)) (string max) (string meal) (getProperty (singleton en.meal) (string !type))))
Für welches Rezept braucht man so lange wie es dauert Reispudding zu kochen	 (listValue (filter (getProperty (singleton en.recipe) (string !type)) (string preparation_time) (string =) (getProperty en.recipe.rice_pudding (string cooking_time))))
Gibt es ein Rezept welches nach 2004 bzw. 2010 gepostet wurde	 (listValue (filter (getProperty (singleton en.recipe) (string !type)) (ensureNumericProperty (string posting_date)) (string >) (ensureNumericEntity (concat (date 2004 -1 -1) (date 2010 -1 -1)))))
Bei welchen Rezepten dauert die Zubereitung so lange wie die Kochdauer eines Reispuddings	 (listValue (filter (getProperty (singleton en.recipe) (string !type)) (string preparation_time) (string =) (getProperty en.recipe.rice_pudding (string cooking_time))))
Welches Rezept wurde vor dem Jahr 2004 oder 2010 veröffentlicht	 (listValue (filter (getProperty (singleton en.recipe) (string !type)) (ensureNumericProperty (string posting_date)) (string <) (ensureNumericEntity (concat (date 2004 -1 -1) (date 2010 -1 -1)))))
Reispudding oder Quiche	 (listValue (concat en.recipe.rice_pudding en.recipe.quiche))
Welches Rezept dauert länger als die Zubereitung von Milchreis	 (listValue (filter (getProperty (singleton en.recipe) (string !type)) (ensureNumericProperty (string preparation_time)) (string >) (ensureNumericEntity (getProperty en.recipe.rice_pudding (string preparation_time)))))
Welches Rezept hat die längste Zubereitungszeit	 (listValue (superlative (getProperty (singleton en.recipe) (string !type)) (string max) (ensureNumericProperty (string cooking_time))))
Welche Rezepte fürs Mittagessen wurden 2004 gepostet	 (listValue (filter (filter (getProperty (singleton en.recipe) (string !type)) (string meal) (string =) en.meal.lunch) (string posting_date) (string =) (date 2004 -1 -1)))
Kennst du ein Rezept das für 2 Portionen ist	 (listValue (countComparative (getProperty (singleton en.recipe) (string !type)) (string meal) (string =) (number 2) (getProperty (singleton en.meal) (string !type))))
Ein Gericht dass weniger als zwei Rezepte hat	 (listValue (countComparative (getProperty (singleton en.meal) (string !type)) (reverse (string meal)) (string <) (number 2) (getProperty (singleton en.recipe) (string !type))))
Bei welchen Rezept braucht man Milch	 (listValue (filter (filter (getProperty (singleton en.recipe) (string !type)) (string requires) (string =) en.ingredient.milk) (string requires) (string =) en.ingredient.milk))
Welches Rezept erfordert keine Milch	 (listValue (filter (getProperty (singleton en.recipe) (string !type)) (string requires) (string !=) en.ingredient.milk))
Hat das Rezept mindestens eine Kochzeit welcher der Zubereitungszeit von Reispudding entspricht	 (listValue (filter (getProperty (singleton en.recipe) (string !type)) (ensureNumericProperty (string cooking_time)) (string >=) (ensureNumericEntity (getProperty en.recipe.rice_pudding (string preparation_time)))))
Was ist die durchschnittliche Vorbereitungszeit für das Rezept	 (listValue (aggregate (string avg) (getProperty (getProperty (singleton en.recipe) (string !type)) (string preparation_time))))
Welches Rezept ist fürs Mittagessen und benötigt Milch als Zutat	 (listValue (filter (filter (getProperty (singleton en.recipe) (string !type)) (string meal) (string =) en.meal.lunch) (string requires) (string =) en.ingredient.milk))
Welches Rezept hat die geringste Zubereitungszeit	 (listValue (superlative (getProperty (singleton en.recipe) (string !type)) (string min) (ensureNumericProperty (string cooking_time))))
Eine Zutat die für mehr als zwei Rezepte benötigt wird	 (listValue (countComparative (getProperty (singleton en.ingredient) (string !type)) (reverse (string requires)) (string >) (number 2) (getProperty (singleton en.recipe) (string !type))))
Gibt es eine Mahlzeit welche möglichst viele Rezepte beinhaltet	 (listValue (countSuperlative (getProperty (singleton en.meal) (string !type)) (string max) (reverse (string meal)) (getProperty (singleton en.recipe) (string !type))))
Welche Rezepte wurden später eingereicht als das von Reispudding	 (listValue (filter (getProperty (singleton en.recipe) (string !type)) (ensureNumericProperty (string posting_date)) (string >) (ensureNumericEntity (getProperty en.recipe.rice_pudding (string posting_date)))))
Ein Rezept dessen Kochzeit weniger dauert wie die Vorbereitung von Reispudding	 (listValue (filter (getProperty (singleton en.recipe) (string !type)) (ensureNumericProperty (string preparation_time)) (string <) (ensureNumericEntity (getProperty en.recipe.rice_pudding (string cooking_time)))))
Wieviel Rezepte haben wir	 (listValue (call .size (getProperty (singleton en.recipe) (string !type))))
Welche Zutaten werde für Milchreis benötigt	 (listValue (filter (filter (getProperty (singleton en.ingredient) (string !type)) (reverse (string requires)) (string =) en.recipe.rice_pudding) (reverse (string requires)) (string =) en.recipe.rice_pudding))
Welches Rezept reicht für mehr als zwei Mahlzeiten	 (listValue (countComparative (getProperty (singleton en.recipe) (string !type)) (string meal) (string >) (number 2) (getProperty (singleton en.meal) (string !type))))
Welches Rezept ist von 2004 und benötigt Milch als Zutat	 (listValue (filter (filter (getProperty (singleton en.recipe) (string !type)) (string requires) (string =) en.ingredient.milk) (string posting_date) (string =) (date 2004 -1 -1)))
Welches Rezept eignet sich als Mittagessen	 (listValue (filter (getProperty (singleton en.recipe) (string !type)) (string meal) (string =) en.meal.lunch))
Wurde das Rezept nach dem Rezept von Reispudding gepostet	 (listValue (filter (getProperty (singleton en.recipe) (string !type)) (ensureNumericProperty (string posting_date)) (string >=) (ensureNumericEntity (getProperty en.recipe.rice_pudding (string posting_date)))))
Ist es ein Rezept welches nicht 2004 gepostet würde	 (listValue (filter (getProperty (singleton en.recipe) (string !type)) (string posting_date) (string !=) (date 2004 -1 -1)))
Welches Rezept dauert länger als die Zubereitung von Milchreis	 (listValue (filter (getProperty (singleton en.recipe) (string !type)) (ensureNumericProperty (string cooking_time)) (string >) (ensureNumericEntity (getProperty en.recipe.rice_pudding (string preparation_time)))))
welche Zutat von dem Rezept wird für das Mittagessen gebraucht	 (listValue (filter (getProperty (singleton en.ingredient) (string !type)) (reverse (string requires)) (string =) (filter (getProperty (singleton en.recipe) (string !type)) (string meal) (string =) en.meal.lunch)))
Welches Rezept hat mindestens zwei Cuisine	 (listValue (countComparative (getProperty (singleton en.recipe) (string !type)) (string cuisine) (string >=) (number 2)))
Welche Rezepte sind für höchstens zwei Mahlzeiten	 (listValue (countComparative (getProperty (singleton en.recipe) (string !type)) (string meal) (string <=) (number 2) (getProperty (singleton en.meal) (string !type))))
Welches Rezept hat die gleiche Zubereitungszeit wie Milchreis	 (listValue (filter (getProperty (singleton en.recipe) (string !type)) (string cooking_time) (string =) (getProperty en.recipe.rice_pudding (string preparation_time))))
Welches Rezept wurde vor 2004 oder 2010 veröffentlicht	 (listValue (filter (getProperty (singleton en.recipe) (string !type)) (ensureNumericProperty (string posting_date)) (string <) (ensureNumericEntity (concat (date 2004 -1 -1) (date 2010 -1 -1)))))
Wie lange ist die durchschnittliche Vorbereitungszeit des Rezepts	 (listValue (aggregate (string avg) (getProperty (getProperty (singleton en.recipe) (string !type)) (string preparation_time))))
Welches Rezept gibt es für Reispudding	 (listValue (filter (getProperty (singleton en.recipe) (string !type)) (string meal) (string =) (filter (getProperty (singleton en.meal) (string !type)) (reverse (string meal)) (string =) en.recipe.rice_pudding)))
Gibt es ein Rezept welches eine maximale Zubereitungszeit wie Reispudding hat	 (listValue (filter (getProperty (singleton en.recipe) (string !type)) (ensureNumericProperty (string preparation_time)) (string <=) (ensureNumericEntity (getProperty en.recipe.rice_pudding (string preparation_time)))))
Welche Mahlzeit hat höchstens zwei Rezepte	 (listValue (countComparative (getProperty (singleton en.meal) (string !type)) (reverse (string meal)) (string <=) (number 2) (getProperty (singleton en.recipe) (string !type))))
Welches Rezept wurde entweder in 2004 oder in 2010 veröffentlicht	 (listValue (filter (getProperty (singleton en.recipe) (string !type)) (string posting_date) (string =) (concat (date 2004 -1 -1) (date 2010 -1 -1))))
Vorbereitungszeit für das Rezept	 (listValue (aggregate (string sum) (getProperty (getProperty (singleton en.recipe) (string !type)) (string preparation_time))))
Haben wir ein Rezept welches eine Vorbereitungszeit hat welche mindestens der Kochzeit von Reispudding entspricht	 (listValue (filter (getProperty (singleton en.recipe) (string !type)) (ensureNumericProperty (string preparation_time)) (string >=) (ensureNumericEntity (getProperty en.recipe.rice_pudding (string cooking_time)))))
Welches Rezept ist nicht für ein Mittagessen	 (listValue (filter (getProperty (singleton en.recipe) (string !type)) (string meal) (string !=) en.meal.lunch))
Welches Gericht hat ein Rezept das im Jahr 2004 veröffentlicht wurde	 (listValue (filter (getProperty (singleton en.meal) (string !type)) (reverse (string meal)) (string =) (filter (getProperty (singleton en.recipe) (string !type)) (string posting_date) (string =) (date 2004 -1 -1))))
Welches Rezept hat die kürzeste Vorbereitungszeit	 (listValue (superlative (getProperty (singleton en.recipe) (string !type)) (string min) (ensureNumericProperty (string preparation_time))))
Für welche Speise gibt es mehr als zwei Rezepte	 (listValue (countComparative (getProperty (singleton en.meal) (string !type)) (reverse (string meal)) (string >) (number 2) (getProperty (singleton en.recipe) (string !type))))
Welches Rezept hat die längste Vorbereitungszeit	 (listValue (superlative (getProperty (singleton en.recipe) (string !type)) (string max) (ensureNumericProperty (string preparation_time))))
Was ist das Rezept das zuletzt geteilt wurde	 (listValue (superlative (getProperty (singleton en.recipe) (string !type)) (string min) (ensureNumericProperty (string posting_date))))
Welches Rezept dauert mindestens so lange wie Milchreis	 (listValue (filter (getProperty (singleton en.recipe) (string !type)) (ensureNumericProperty (string preparation_time)) (string >=) (ensureNumericEntity (getProperty en.recipe.rice_pudding (string preparation_time)))))
Wie hoch ist die Kochdauer von Reispudding	 (listValue (getProperty en.recipe.rice_pudding (string cooking_time)))
Welches Rezept benötigt fast genau solange wie die Zubereitung von Milchreis	 (listValue (filter (getProperty (singleton en.recipe) (string !type)) (ensureNumericProperty (string preparation_time)) (string <=) (ensureNumericEntity (getProperty en.recipe.rice_pudding (string cooking_time)))))
Wie viele Rezepte gibt es in diesem Rezeptur	 (listValue (call .size (getProperty (singleton en.recipe) (string !type))))
Welches Rezept benötigt mindestens die gleiche Zubereitungszeit wie Reispudding	 (listValue (filter (getProperty (singleton en.recipe) (string !type)) (ensureNumericProperty (string cooking_time)) (string >=) (ensureNumericEntity (getProperty en.recipe.rice_pudding (string preparation_time)))))
Welches Rezept ist nicht für das Mittagessen geeignet	 (listValue (filter (getProperty (singleton en.recipe) (string !type)) (string meal) (string !=) en.meal.lunch))
Welche Zutat wird im Rezept welches in 2004 veröffentlicht wurde verwendet	 (listValue (filter (getProperty (singleton en.ingredient) (string !type)) (reverse (string requires)) (string =) (filter (getProperty (singleton en.recipe) (string !type)) (string posting_date) (string =) (date 2004 -1 -1))))
Ist es von 2004 oder 2010	 (listValue (concat (date 2004 -1 -1) (date 2010 -1 -1)))
Welches Rezept entspricht von der Zubereitungsdauer einem Reispudding	 (listValue (filter (getProperty (singleton en.recipe) (string !type)) (ensureNumericProperty (string cooking_time)) (string <=) (ensureNumericEntity (getProperty en.recipe.rice_pudding (string cooking_time)))))
Welches Rezept wurde vor 2005 veröffentlicht	 (listValue (filter (getProperty (singleton en.recipe) (string !type)) (ensureNumericProperty (string posting_date)) (string <=) (ensureNumericEntity (date 2004 -1 -1))))
Welche Rezepte sind für Mittagessen	 (listValue (filter (getProperty (singleton en.recipe) (string !type)) (string meal) (string =) en.meal.lunch))
Willst du Reispudding oder Quiche	 (listValue (concat en.recipe.rice_pudding en.recipe.quiche))
Welche Zutaten werden in Rezepten gebraucht die seit 2004 bekannt sind	 (listValue (filter (getProperty (singleton en.ingredient) (string !type)) (reverse (string requires)) (string =) (filter (getProperty (singleton en.recipe) (string !type)) (string posting_date) (string =) (date 2004 -1 -1))))
Welche Rezepte sind für mehr als 2 Mahlzeiten	 (listValue (countComparative (getProperty (singleton en.recipe) (string !type)) (string meal) (string >) (number 2) (getProperty (singleton en.meal) (string !type))))
Für welches Mittagsrezept braucht man Milch	 (listValue (filter (filter (getProperty (singleton en.recipe) (string !type)) (string meal) (string =) en.meal.lunch) (string requires) (string =) en.ingredient.milk))
Welche Zutat wird von zwei Rezepten benötigt	 (listValue (countComparative (getProperty (singleton en.ingredient) (string !type)) (reverse (string requires)) (string =) (number 2) (getProperty (singleton en.recipe) (string !type))))
Was ist dieses Rezept dessen Vorbereitung genauso lange dauert wie die des Reispuddings	 (listValue (filter (getProperty (singleton en.recipe) (string !type)) (string preparation_time) (string =) (getProperty en.recipe.rice_pudding (string preparation_time))))
Wie viele Zutaten hat das Rezept	 (listValue (call .size (getProperty (singleton en.ingredient) (string !type))))
Hast du ein Rezept fuer zwei Personen	 (listValue (countComparative (getProperty (singleton en.recipe) (string !type)) (string meal) (string =) (number 2) (getProperty (singleton en.meal) (string !type))))
Schmeckt die Mahlzeit dessen Rezept 2004 gepostet wurde	 (listValue (filter (getProperty (singleton en.meal) (string !type)) (reverse (string meal)) (string =) (filter (getProperty (singleton en.recipe) (string !type)) (string posting_date) (string =) (date 2004 -1 -1))))
Was ist das beste Rezept welches die wenigsten Zutaten benoetigt	 (listValue (countSuperlative (getProperty (singleton en.recipe) (string !type)) (string min) (string requires) (getProperty (singleton en.ingredient) (string !type))))
Die komplette Kochzeit des Rezepts	 (listValue (aggregate (string sum) (getProperty (getProperty (singleton en.recipe) (string !type)) (string cooking_time))))
Welches Rezept benötigt zwei Zutaten	 (listValue (countComparative (getProperty (singleton en.recipe) (string !type)) (string requires) (string =) (number 2) (getProperty (singleton en.ingredient) (string !type))))
Welche Rezepte für Mittagessen wurden 2004 gepostet	 (listValue (filter (filter (getProperty (singleton en.recipe) (string !type)) (string meal) (string =) en.meal.lunch) (string posting_date) (string =) (date 2004 -1 -1)))
Welches Rezept wurde 2004 gepostet	 (listValue (filter (getProperty (singleton en.recipe) (string !type)) (string posting_date) (string =) (date 2004 -1 -1)))
Welche Zutaten werden von nicht mehr als zwei Rezepten benötigt	 (listValue (countComparative (getProperty (singleton en.ingredient) (string !type)) (reverse (string requires)) (string <=) (number 2) (getProperty (singleton en.recipe) (string !type))))
Welches Rezept wurde gleichzeitig mit dem Rezept für Milchreis veröffenlicht	 (listValue (filter (getProperty (singleton en.recipe) (string !type)) (string posting_date) (string =) (getProperty en.recipe.rice_pudding (string posting_date))))
Welches Rezept stammt aus der geringsten Anzahl an Küchen	 (listValue (countSuperlative (getProperty (singleton en.recipe) (string !type)) (string min) (string cuisine)))
Welches Rezept hat eine kürzere Zubereitungszeit als Reispudding	 (listValue (filter (getProperty (singleton en.recipe) (string !type)) (ensureNumericProperty (string cooking_time)) (string <) (ensureNumericEntity (getProperty en.recipe.rice_pudding (string preparation_time)))))
Welches Rezept benötigt die gleiche Zutat wie Reispudding	 (listValue (filter (getProperty (singleton en.recipe) (string !type)) (string requires) (string =) (filter (getProperty (singleton en.ingredient) (string !type)) (reverse (string requires)) (string =) en.recipe.rice_pudding)))
Welches Rezept braucht nur zwei Zutaten	 (listValue (countComparative (getProperty (singleton en.recipe) (string !type)) (string requires) (string >=) (number 2) (getProperty (singleton en.ingredient) (string !type))))
Was ist das Rezept das in 2004 geteilt wurde und das Milch benoetigt	 (listValue (filter (filter (getProperty (singleton en.recipe) (string !type)) (string posting_date) (string =) (date 2004 -1 -1)) (string requires) (string =) en.ingredient.milk))
Welches Rezept benötigt mehr als zwei Zutaten	 (listValue (countComparative (getProperty (singleton en.recipe) (string !type)) (string requires) (string >) (number 2) (getProperty (singleton en.ingredient) (string !type))))
Welche Rezepte enthalten entweder Milch oder Spinat	 (listValue (filter (getProperty (singleton en.recipe) (string !type)) (string requires) (string =) (concat en.ingredient.milk en.ingredient.spinach)))
Welches Rezept hat die wenigsten Cuisine	 (listValue (countSuperlative (getProperty (singleton en.recipe) (string !type)) (string min) (string cuisine)))
Ich suche ein Rezept welches nicht 2004 veröffentlicht wurde	 (listValue (filter (getProperty (singleton en.recipe) (string !type)) (string posting_date) (string !=) (date 2004 -1 -1)))
Zu welcher Mahlzeit ist man keinen Reispudding	 (listValue (filter (getProperty (singleton en.meal) (string !type)) (reverse (string meal)) (string !=) en.recipe.rice_pudding))
Welches Rezept braucht die wenigsten Zutaten	 (listValue (countSuperlative (getProperty (singleton en.recipe) (string !type)) (string min) (string requires) (getProperty (singleton en.ingredient) (string !type))))
Welche Rezepte passen sowohl zum Mittag als auch zum Abendessen	 (listValue (concat en.meal.lunch en.meal.dinner))
Welches Rezept wurde nach 2004 veröffentlicht	 (listValue (filter (getProperty (singleton en.recipe) (string !type)) (ensureNumericProperty (string posting_date)) (string >) (ensureNumericEntity (date 2004 -1 -1))))
Welches Rezept hat die kürzeste Kochzeit	 (listValue (superlative (getProperty (singleton en.recipe) (string !type)) (string min) (ensureNumericProperty (string cooking_time))))
Haben wir ein Rezept dessen Zubereitungszeit unter der Kochzeit von Reispudding liegt	 (listValue (filter (getProperty (singleton en.recipe) (string !type)) (ensureNumericProperty (string preparation_time)) (string <) (ensureNumericEntity (getProperty en.recipe.rice_pudding (string cooking_time)))))
Für welche Mahlzeit gibt es höchstens zwei Rezepte	 (listValue (countComparative (getProperty (singleton en.meal) (string !type)) (reverse (string meal)) (string <=) (number 2) (getProperty (singleton en.recipe) (string !type))))
Welches Rezept wurde spätestens 2004 veröffentlicht	 (listValue (filter (getProperty (singleton en.recipe) (string !type)) (ensureNumericProperty (string posting_date)) (string <=) (ensureNumericEntity (date 2004 -1 -1))))
Welches Gericht ist fürs Mittagessen geeignet	 (listValue (filter (getProperty (singleton en.recipe) (string !type)) (string meal) (string =) en.meal.lunch))
Welches Rezept wurde 2004 eingestellt	 (listValue (filter (filter (getProperty (singleton en.recipe) (string !type)) (string posting_date) (string =) (date 2004 -1 -1)) (string posting_date) (string =) (date 2004 -1 -1)))
Welches Rezept ist das zeitaufwändigste	 (listValue (superlative (getProperty (singleton en.recipe) (string !type)) (string max) (ensureNumericProperty (string preparation_time))))
Welches Rezept wurde vor 2004 veröffentlicht	 (listValue (filter (getProperty (singleton en.recipe) (string !type)) (ensureNumericProperty (string posting_date)) (string >) (ensureNumericEntity (date 2004 -1 -1))))
Haben Sie ein Rezept für ein Mahl für mehr als zwei Personen 	 (listValue (countComparative (getProperty (singleton en.recipe) (string !type)) (string meal) (string >) (number 2) (getProperty (singleton en.meal) (string !type))))
Die durchschnittliche Kochzeit des Rezepts	 (listValue (aggregate (string avg) (getProperty (getProperty (singleton en.recipe) (string !type)) (string cooking_time))))
Welches Rezept wurde vor 2004 veröffentlicht	 (listValue (filter (getProperty (singleton en.recipe) (string !type)) (string posting_date) (string =) (date 2004 -1 -1)))
Ein Rezept was nicht so lange braucht wie das Kochen von Reispudding	 (listValue (filter (getProperty (singleton en.recipe) (string !type)) (ensureNumericProperty (string cooking_time)) (string <) (ensureNumericEntity (getProperty en.recipe.rice_pudding (string cooking_time)))))
Welche Zutat braucht man für Reispudding	 (listValue (filter (getProperty (singleton en.ingredient) (string !type)) (reverse (string requires)) (string =) en.recipe.rice_pudding))
Welches Rezept ist mit Milch gemacht	 (listValue (filter (getProperty (singleton en.recipe) (string !type)) (string requires) (string =) en.ingredient.milk))
Welche Zutat wird von mindestens zwei Rezepten benötigt	 (listValue (countComparative (getProperty (singleton en.ingredient) (string !type)) (reverse (string requires)) (string >) (number 2) (getProperty (singleton en.recipe) (string !type))))
Welches Gericht benötig Milchreis	 (listValue (filter (filter (getProperty (singleton en.meal) (string !type)) (reverse (string meal)) (string =) en.recipe.rice_pudding) (reverse (string meal)) (string =) en.recipe.rice_pudding))
Was ist ein Rezept das nicht Feuers Mittagessen bestimmt ist	 (listValue (filter (getProperty (singleton en.recipe) (string !type)) (string meal) (string !=) en.meal.lunch))
Welches Rezept stammt aus mehr als zwei verschiedenen Küchenkulturen	 (listValue (countComparative (getProperty (singleton en.recipe) (string !type)) (string cuisine) (string >) (number 2)))
Welches Rezept wurde nach 2004 oder 2010 veröffentlicht	 (listValue (filter (getProperty (singleton en.recipe) (string !type)) (ensureNumericProperty (string posting_date)) (string >) (ensureNumericEntity (concat (date 2004 -1 -1) (date 2010 -1 -1)))))
Für welches Rezept braucht man die wenigsten Zutaten	 (listValue (countSuperlative (getProperty (singleton en.recipe) (string !type)) (string min) (string requires) (getProperty (singleton en.ingredient) (string !type))))
Welches Rezept kann mehr als zwei Küchen zugeordnet werden	 (listValue (countComparative (getProperty (singleton en.recipe) (string !type)) (string cuisine) (string >) (number 2)))
Ein Rezept dessen Kochzeit ist mindestens so lange wie die Vorbereitung von Reispudding	 (listValue (filter (getProperty (singleton en.recipe) (string !type)) (ensureNumericProperty (string cooking_time)) (string >=) (ensureNumericEntity (getProperty en.recipe.rice_pudding (string preparation_time)))))
Für welches Gericht wird der Reispudding benötigt	 (listValue (filter (getProperty (singleton en.meal) (string !type)) (reverse (string meal)) (string =) en.recipe.rice_pudding))
Welches Rezept benötigt die wenigsten Utensilien	 (listValue (countSuperlative (getProperty (singleton en.recipe) (string !type)) (string min) (string cuisine)))
Gibt es ein Rezept das dieselbe Zubereitungszeit wie Reispudding hat	 (listValue (filter (getProperty (singleton en.recipe) (string !type)) (string preparation_time) (string =) (getProperty en.recipe.rice_pudding (string preparation_time))))
Kennst du ein Rezept was für mehr als zwei Mahlzeiten gedacht ist	 (listValue (countComparative (getProperty (singleton en.meal) (string !type)) (reverse (string meal)) (string >) (number 2) (getProperty (singleton en.recipe) (string !type))))
Welches Rezept ist fürs Mittagessen oder Abendessen geeignet	 (listValue (filter (getProperty (singleton en.recipe) (string !type)) (string meal) (string =) (concat en.meal.lunch en.meal.dinner)))
Wie lange dauert die Zubereitung des Rezepts	 (listValue (aggregate (string sum) (getProperty (getProperty (singleton en.recipe) (string !type)) (string preparation_time))))
Welches Rezept benötigt höchstens die gleiche Kochzeit wie Reispudding	 (listValue (filter (getProperty (singleton en.recipe) (string !type)) (ensureNumericProperty (string preparation_time)) (string <=) (ensureNumericEntity (getProperty en.recipe.rice_pudding (string cooking_time)))))
Welche Rezepte benötigen Milch und werden zu Mittag gegessen	 (listValue (filter (filter (getProperty (singleton en.recipe) (string !type)) (string meal) (string =) en.meal.lunch) (string requires) (string =) en.ingredient.milk))
Welches Rezept ist für mindestens zwei Mahlzeiten	 (listValue (countComparative (getProperty (singleton en.recipe) (string !type)) (string meal) (string >=) (number 2) (getProperty (singleton en.meal) (string !type))))
Welche Rezepte benötigen Milch und eignen sich fürs Mittagessen	 (listValue (filter (filter (getProperty (singleton en.recipe) (string !type)) (string requires) (string =) en.ingredient.milk) (string meal) (string =) en.meal.lunch))
Welcher ist der Beleg mit dem 2004 Versanddatum	 (listValue (filter (filter (getProperty (singleton en.recipe) (string !type)) (string posting_date) (string =) (date 2004 -1 -1)) (string posting_date) (string =) (date 2004 -1 -1)))
Wieviel Zeit braucht man um Reispudding zu kochen	 (listValue (getProperty en.recipe.rice_pudding (string preparation_time)))
Wird diese Zutat für mindestens 2 Rezepte gebraucht	 (listValue (countComparative (getProperty (singleton en.ingredient) (string !type)) (reverse (string requires)) (string >=) (number 2) (getProperty (singleton en.recipe) (string !type))))
Für welche Mahlzeit eignet sich Reispudding oder Quiche	 (listValue (filter (getProperty (singleton en.meal) (string !type)) (reverse (string meal)) (string =) (concat en.recipe.rice_pudding en.recipe.quiche)))
