what meal has two or fewer recipes designated for it	 (listValue (countComparative (getProperty (singleton en.meal) (string !type)) (reverse (string meal)) (string <=) (number 2) (getProperty (singleton en.recipe) (string !type))))
show me recipes with a preparation time equal to or greater than the cooking time of rice pudding	 (listValue (filter (getProperty (singleton en.recipe) (string !type)) (ensureNumericProperty (string preparation_time)) (string >=) (ensureNumericEntity (getProperty en.recipe.rice_pudding (string cooking_time)))))
find a recipe thatll feed two people	 (listValue (countComparative (getProperty (singleton en.recipe) (string !type)) (string meal) (string =) (number 2) (getProperty (singleton en.meal) (string !type))))
what ingredient is in two or less recipes	 (listValue (countComparative (getProperty (singleton en.ingredient) (string !type)) (reverse (string requires)) (string <=) (number 2) (getProperty (singleton en.recipe) (string !type))))
which recipes make at least 2 meals	 (listValue (countComparative (getProperty (singleton en.recipe) (string !type)) (string meal) (string >=) (number 2) (getProperty (singleton en.meal) (string !type))))
what two ingredients does that recipe require	 (listValue (countComparative (getProperty (singleton en.ingredient) (string !type)) (reverse (string requires)) (string =) (number 2) (getProperty (singleton en.recipe) (string !type))))
how many ingredients does that require	 (listValue (call .size (getProperty (singleton en.ingredient) (string !type))))
show me lunch recipes	 (listValue (filter (filter (getProperty (singleton en.recipe) (string !type)) (string meal) (string =) en.meal.lunch) (string meal) (string =) en.meal.lunch))
what recipe can be prepped in less time than rice pudding can be cooked	 (listValue (filter (getProperty (singleton en.recipe) (string !type)) (ensureNumericProperty (string preparation_time)) (string <) (ensureNumericEntity (getProperty en.recipe.rice_pudding (string cooking_time)))))
how many recipes are there	 (listValue (call .size (getProperty (singleton en.recipe) (string !type))))
what recipes posting date is at least the same as rice pudding	 (listValue (filter (getProperty (singleton en.recipe) (string !type)) (ensureNumericProperty (string posting_date)) (string >=) (ensureNumericEntity (getProperty en.recipe.rice_pudding (string posting_date)))))
show recipes that could be used in any meal	 (listValue (countComparative (getProperty (singleton en.recipe) (string !type)) (string meal) (string >) (number 2) (getProperty (singleton en.meal) (string !type))))
what type of cuisine is rice pudding	 (listValue (getProperty en.recipe.rice_pudding (string cuisine)))
find a recipe that takes the same time to cook as rice pudding	 (listValue (filter (getProperty (singleton en.recipe) (string !type)) (string preparation_time) (string =) (getProperty en.recipe.rice_pudding (string preparation_time))))
what recipe serves at the most three	 (listValue (countSuperlative (getProperty (singleton en.recipe) (string !type)) (string max) (string meal) (getProperty (singleton en.meal) (string !type))))
the lunch recipe posting date is 2004	 (listValue (filter (filter (getProperty (singleton en.recipe) (string !type)) (string posting_date) (string =) (date 2004 -1 -1)) (string meal) (string =) en.meal.lunch))
show me lunch recipes that require milk	 (listValue (filter (filter (getProperty (singleton en.recipe) (string !type)) (string meal) (string =) en.meal.lunch) (string requires) (string =) en.ingredient.milk))
what is a recipe from the fewest cuisines	 (listValue (countSuperlative (getProperty (singleton en.recipe) (string !type)) (string min) (string cuisine)))
what recipes share ingredients	 (listValue (countComparative (getProperty (singleton en.ingredient) (string !type)) (reverse (string requires)) (string =) (number 2) (getProperty (singleton en.recipe) (string !type))))
what is the meal that rice pudding goes with	 (listValue (filter (filter (getProperty (singleton en.meal) (string !type)) (reverse (string meal)) (string =) en.recipe.rice_pudding) (reverse (string meal)) (string =) en.recipe.rice_pudding))
what recipes cooking time is at least the preparation time of rice pudding	 (listValue (filter (getProperty (singleton en.recipe) (string !type)) (ensureNumericProperty (string cooking_time)) (string >=) (ensureNumericEntity (getProperty en.recipe.rice_pudding (string preparation_time)))))
name ingredients used in more than one recipe	 (listValue (countComparative (getProperty (singleton en.ingredient) (string !type)) (reverse (string requires)) (string =) (number 2) (getProperty (singleton en.recipe) (string !type))))
what recipes posting date is not in 2004	 (listValue (filter (getProperty (singleton en.recipe) (string !type)) (string posting_date) (string !=) (date 2004 -1 -1)))
recipe for the most number of meal	 (listValue (countSuperlative (getProperty (singleton en.recipe) (string !type)) (string max) (string meal) (getProperty (singleton en.meal) (string !type))))
what recipe has one cuisine	 (listValue (countComparative (getProperty (singleton en.recipe) (string !type)) (string cuisine) (string <) (number 2)))
what recipe requires milk	 (listValue (filter (getProperty (singleton en.ingredient) (string !type)) (reverse (string requires)) (string =) (filter (getProperty (singleton en.recipe) (string !type)) (string requires) (string =) en.ingredient.milk)))
show me recipes that required two or more ingredients	 (listValue (countComparative (getProperty (singleton en.recipe) (string !type)) (string requires) (string >=) (number 2) (getProperty (singleton en.ingredient) (string !type))))
show me ingredients that two recipes require	 (listValue (countComparative (getProperty (singleton en.ingredient) (string !type)) (reverse (string requires)) (string =) (number 2) (getProperty (singleton en.recipe) (string !type))))
what is a recipe used for fewer than two meals	 (listValue (countComparative (getProperty (singleton en.recipe) (string !type)) (string meal) (string <) (number 2) (getProperty (singleton en.meal) (string !type))))
what recipe takes longer to cook than rice pudding	 (listValue (filter (getProperty (singleton en.recipe) (string !type)) (ensureNumericProperty (string cooking_time)) (string >) (ensureNumericEntity (getProperty en.recipe.rice_pudding (string cooking_time)))))
which ingredient is needed in the least number of recipes	 (listValue (countSuperlative (getProperty (singleton en.ingredient) (string !type)) (string min) (reverse (string requires)) (getProperty (singleton en.recipe) (string !type))))
which recipe has its posting date as 2004	 (listValue (filter (getProperty (singleton en.recipe) (string !type)) (string posting_date) (string =) (date 2004 -1 -1)))
which food item is not needed in rice pudding	 (listValue (filter (getProperty (singleton en.ingredient) (string !type)) (reverse (string requires)) (string !=) en.recipe.rice_pudding))
what recipes have the most ingredients	 (listValue (countSuperlative (getProperty (singleton en.recipe) (string !type)) (string max) (string requires) (getProperty (singleton en.ingredient) (string !type))))
for what meal can maximum recipes be found	 (listValue (countSuperlative (getProperty (singleton en.meal) (string !type)) (string max) (reverse (string meal)) (getProperty (singleton en.recipe) (string !type))))
how much time it takes to cook rice pudding 	 (listValue (getProperty en.recipe.rice_pudding (string cooking_time)))
show me recipes that are not lunch recipes	 (listValue (filter (getProperty (singleton en.recipe) (string !type)) (string meal) (string !=) en.meal.lunch))
show me meals requiring milk	 (listValue (filter (getProperty (singleton en.meal) (string !type)) (reverse (string meal)) (string =) (filter (getProperty (singleton en.recipe) (string !type)) (string requires) (string =) en.ingredient.milk)))
what are ingredients in rice pudding	 (listValue (filter (filter (getProperty (singleton en.ingredient) (string !type)) (reverse (string requires)) (string =) en.recipe.rice_pudding) (reverse (string requires)) (string =) en.recipe.rice_pudding))
show recipes with the preparation time as the cooking time of rice pudding	 (listValue (filter (getProperty (singleton en.recipe) (string !type)) (string preparation_time) (string =) (getProperty en.recipe.rice_pudding (string cooking_time))))
show me recipes with cooking time greater than preparation time for rice pudding	 (listValue (filter (getProperty (singleton en.recipe) (string !type)) (ensureNumericProperty (string cooking_time)) (string >) (ensureNumericEntity (getProperty en.recipe.rice_pudding (string preparation_time)))))
find lunch recipes posted in 2004	 (listValue (filter (filter (getProperty (singleton en.recipe) (string !type)) (string posting_date) (string =) (date 2004 -1 -1)) (string meal) (string =) en.meal.lunch))
ingredients in recipe posted in 2004	 (listValue (filter (getProperty (singleton en.ingredient) (string !type)) (reverse (string requires)) (string =) (filter (getProperty (singleton en.recipe) (string !type)) (string posting_date) (string =) (date 2004 -1 -1))))
what is the recipe that needs the minimum number of ingredients	 (listValue (countSuperlative (getProperty (singleton en.recipe) (string !type)) (string min) (string requires) (getProperty (singleton en.ingredient) (string !type))))
what recipes cooking time is the same as rice pudding	 (listValue (filter (getProperty (singleton en.recipe) (string !type)) (string cooking_time) (string =) (getProperty en.recipe.rice_pudding (string cooking_time))))
which recipe requires the most ingredients	 (listValue (countSuperlative (getProperty (singleton en.recipe) (string !type)) (string max) (string requires) (getProperty (singleton en.ingredient) (string !type))))
recipes prepared in rice puddings cooking time	 (listValue (filter (getProperty (singleton en.recipe) (string !type)) (string preparation_time) (string =) (getProperty en.recipe.rice_pudding (string cooking_time))))
what is a recipe that is good for lunch or dinner	 (listValue (filter (getProperty (singleton en.recipe) (string !type)) (string meal) (string =) (concat en.meal.lunch en.meal.dinner)))
ingredients required in less than three recipes	 (listValue (countComparative (getProperty (singleton en.ingredient) (string !type)) (reverse (string requires)) (string <=) (number 2) (getProperty (singleton en.recipe) (string !type))))
what is a lunch recipe	 (listValue (filter (filter (getProperty (singleton en.recipe) (string !type)) (string meal) (string =) en.meal.lunch) (string meal) (string =) en.meal.lunch))
show recipes that follow more than two cuisines	 (listValue (countComparative (getProperty (singleton en.recipe) (string !type)) (string cuisine) (string >) (number 2)))
show me recipes that take less time to prepare than rice pudding	 (listValue (filter (getProperty (singleton en.recipe) (string !type)) (ensureNumericProperty (string cooking_time)) (string <) (ensureNumericEntity (getProperty en.recipe.rice_pudding (string preparation_time)))))
what recipe requiring milk makes a lunch meal	 (listValue (filter (filter (getProperty (singleton en.recipe) (string !type)) (string meal) (string =) en.meal.lunch) (string requires) (string =) en.ingredient.milk))
show me recipes that posted no later than the rice pudding recipe	 (listValue (filter (getProperty (singleton en.recipe) (string !type)) (ensureNumericProperty (string posting_date)) (string <=) (ensureNumericEntity (getProperty en.recipe.rice_pudding (string posting_date)))))
what ingredients does rice pudding need	 (listValue (filter (filter (getProperty (singleton en.ingredient) (string !type)) (reverse (string requires)) (string =) en.recipe.rice_pudding) (reverse (string requires)) (string =) en.recipe.rice_pudding))
what is the total cooking time of the recipe	 (listValue (aggregate (string sum) (getProperty (getProperty (singleton en.recipe) (string !type)) (string cooking_time))))
what is a recipe that was not posted in 2004	 (listValue (filter (getProperty (singleton en.recipe) (string !type)) (string posting_date) (string !=) (date 2004 -1 -1)))
what is the used milk or spinach	 (listValue (concat en.ingredient.milk en.ingredient.spinach))
which recipe has the longest ingredient list	 (listValue (countSuperlative (getProperty (singleton en.recipe) (string !type)) (string max) (string requires) (getProperty (singleton en.ingredient) (string !type))))
what is cuisine for rice pudding	 (listValue (getProperty en.recipe.rice_pudding (string cuisine)))
show me recipes for two meals at most	 (listValue (countComparative (getProperty (singleton en.recipe) (string !type)) (string meal) (string <=) (number 2) (getProperty (singleton en.meal) (string !type))))
show me recipes that work for more than one meal	 (listValue (countSuperlative (getProperty (singleton en.recipe) (string !type)) (string min) (string meal) (getProperty (singleton en.meal) (string !type))))
what recipe requires fewer than two ingredients	 (listValue (countComparative (getProperty (singleton en.recipe) (string !type)) (string requires) (string <) (number 2) (getProperty (singleton en.ingredient) (string !type))))
what meal is rice pudding or quiche made for	 (listValue (filter (getProperty (singleton en.meal) (string !type)) (reverse (string meal)) (string =) (concat en.recipe.rice_pudding en.recipe.quiche)))
how long does it take to prepare rice pudding	 (listValue (getProperty en.recipe.rice_pudding (string preparation_time)))
show me the most required ingredient in recipes	 (listValue (countSuperlative (getProperty (singleton en.ingredient) (string !type)) (string max) (reverse (string requires)) (getProperty (singleton en.recipe) (string !type))))
what is the average preparation time for a recipe	 (listValue (aggregate (string avg) (getProperty (getProperty (singleton en.recipe) (string !type)) (string preparation_time))))
show the recipe that takes the longest time to cook	 (listValue (superlative (getProperty (singleton en.recipe) (string !type)) (string max) (ensureNumericProperty (string cooking_time))))
what is the average preparation time of that recipe	 (listValue (aggregate (string avg) (getProperty (getProperty (singleton en.recipe) (string !type)) (string preparation_time))))
which recipes were posted up to 2004 or 2010	 (listValue (filter (getProperty (singleton en.recipe) (string !type)) (ensureNumericProperty (string posting_date)) (string <=) (ensureNumericEntity (concat (date 2004 -1 -1) (date 2010 -1 -1)))))
what is an ingredient found in fewer than two recipes	 (listValue (countComparative (getProperty (singleton en.ingredient) (string !type)) (reverse (string requires)) (string <) (number 2) (getProperty (singleton en.recipe) (string !type))))
recipe that first posted	 (listValue (superlative (getProperty (singleton en.recipe) (string !type)) (string min) (ensureNumericProperty (string posting_date))))
what recipe requires three or more ingredients	 (listValue (countComparative (getProperty (singleton en.recipe) (string !type)) (string requires) (string >) (number 2) (getProperty (singleton en.ingredient) (string !type))))
what recipes posting date is 2004 and requires milk	 (listValue (filter (filter (getProperty (singleton en.recipe) (string !type)) (string posting_date) (string =) (date 2004 -1 -1)) (string requires) (string =) en.ingredient.milk))
what meal has two or more recipes	 (listValue (countComparative (getProperty (singleton en.meal) (string !type)) (reverse (string meal)) (string >=) (number 2) (getProperty (singleton en.recipe) (string !type))))
ingredient required by least number of recipes	 (listValue (countSuperlative (getProperty (singleton en.ingredient) (string !type)) (string min) (reverse (string requires)) (getProperty (singleton en.recipe) (string !type))))
what is an ingredient found in a recipe for rice pudding or quiche	 (listValue (filter (getProperty (singleton en.ingredient) (string !type)) (reverse (string requires)) (string =) (concat en.recipe.rice_pudding en.recipe.quiche)))
list the recipes for lunch or dinner	 (listValue (filter (getProperty (singleton en.recipe) (string !type)) (string meal) (string =) (concat en.meal.lunch en.meal.dinner)))
what recipes takes more time to prepare than rice pudding	 (listValue (filter (getProperty (singleton en.recipe) (string !type)) (ensureNumericProperty (string cooking_time)) (string >) (ensureNumericEntity (getProperty en.recipe.rice_pudding (string cooking_time)))))
recipe with cooking time not more than that of rice pudding	 (listValue (filter (getProperty (singleton en.recipe) (string !type)) (ensureNumericProperty (string cooking_time)) (string <=) (ensureNumericEntity (getProperty en.recipe.rice_pudding (string preparation_time)))))
which recipes fall under more than two cuisines	 (listValue (countComparative (getProperty (singleton en.recipe) (string !type)) (string cuisine) (string >) (number 2)))
find a meal without rice pudding	 (listValue (filter (getProperty (singleton en.meal) (string !type)) (reverse (string meal)) (string !=) en.recipe.rice_pudding))
spinach or milk	 (listValue (concat en.ingredient.milk en.ingredient.spinach))
what is the cooking time of rice pudding	 (listValue (getProperty en.recipe.rice_pudding (string cooking_time)))
show me recipes requiring one ingredient	 (listValue (countComparative (getProperty (singleton en.recipe) (string !type)) (string requires) (string <) (number 2) (getProperty (singleton en.ingredient) (string !type))))
what recipe takes the longest time to prep	 (listValue (superlative (getProperty (singleton en.recipe) (string !type)) (string max) (ensureNumericProperty (string preparation_time))))
what is a recipe from more than two cuisines	 (listValue (countComparative (getProperty (singleton en.recipe) (string !type)) (string cuisine) (string >) (number 2)))
what is the prep time for rice pudding	 (listValue (getProperty en.recipe.rice_pudding (string preparation_time)))
find all recipes posted after 2004	 (listValue (filter (getProperty (singleton en.recipe) (string !type)) (ensureNumericProperty (string posting_date)) (string >) (ensureNumericEntity (concat (date 2004 -1 -1) (date 2010 -1 -1)))))
what are ingredients required by the recipe posted in 2004	 (listValue (filter (getProperty (singleton en.ingredient) (string !type)) (reverse (string requires)) (string =) (filter (getProperty (singleton en.recipe) (string !type)) (string posting_date) (string =) (date 2004 -1 -1))))
which meal has less than two recipes	 (listValue (countComparative (getProperty (singleton en.meal) (string !type)) (reverse (string meal)) (string <) (number 2) (getProperty (singleton en.recipe) (string !type))))
for what meal are there the fewest number of recipes	 (listValue (countSuperlative (getProperty (singleton en.meal) (string !type)) (string min) (reverse (string meal)) (getProperty (singleton en.recipe) (string !type))))
show me preparation time for rice pudding	 (listValue (getProperty en.recipe.rice_pudding (string preparation_time)))
what ingredient is there in less recipes	 (listValue (countSuperlative (getProperty (singleton en.ingredient) (string !type)) (string min) (reverse (string requires)) (getProperty (singleton en.recipe) (string !type))))
what recipe takes less time to cook than rice pudding does to prepare	 (listValue (filter (getProperty (singleton en.recipe) (string !type)) (ensureNumericProperty (string cooking_time)) (string <) (ensureNumericEntity (getProperty en.recipe.rice_pudding (string preparation_time)))))
what is the mean cooking time for the recipe	 (listValue (aggregate (string avg) (getProperty (getProperty (singleton en.recipe) (string !type)) (string cooking_time))))
show me recipes posted before 2004 or before 2010	 (listValue (filter (getProperty (singleton en.recipe) (string !type)) (ensureNumericProperty (string posting_date)) (string <) (ensureNumericEntity (concat (date 2004 -1 -1) (date 2010 -1 -1)))))
show me ingredients not required for rice pudding	 (listValue (filter (getProperty (singleton en.ingredient) (string !type)) (reverse (string requires)) (string !=) en.recipe.rice_pudding))
which recipe was not posted in 2004	 (listValue (filter (getProperty (singleton en.recipe) (string !type)) (string posting_date) (string !=) (date 2004 -1 -1)))
which recipe was posted at the posting date of rice pudding	 (listValue (filter (getProperty (singleton en.recipe) (string !type)) (ensureNumericProperty (string posting_date)) (string <=) (ensureNumericEntity (getProperty en.recipe.rice_pudding (string posting_date)))))
show me recipes posted in 2004 or later	 (listValue (filter (getProperty (singleton en.recipe) (string !type)) (ensureNumericProperty (string posting_date)) (string >=) (ensureNumericEntity (date 2004 -1 -1))))
find recipes that were posted before the recipe for rice pudding	 (listValue (filter (getProperty (singleton en.recipe) (string !type)) (ensureNumericProperty (string posting_date)) (string <) (ensureNumericEntity (getProperty en.recipe.rice_pudding (string posting_date)))))
what is the newest recipe	 (listValue (superlative (getProperty (singleton en.recipe) (string !type)) (string max) (ensureNumericProperty (string posting_date))))
how long does rice pudding take to prep	 (listValue (getProperty en.recipe.rice_pudding (string preparation_time)))
cooking time of recipe	 (listValue (aggregate (string sum) (getProperty (getProperty (singleton en.recipe) (string !type)) (string cooking_time))))
what recipe is the oldest	 (listValue (superlative (getProperty (singleton en.recipe) (string !type)) (string min) (ensureNumericProperty (string posting_date))))
what type of cuisine is rice pudding	 (listValue (getProperty en.recipe.rice_pudding (string cuisine)))
what ingredients are used only for lunch	 (listValue (filter (getProperty (singleton en.ingredient) (string !type)) (reverse (string requires)) (string =) (filter (getProperty (singleton en.recipe) (string !type)) (string meal) (string =) en.meal.lunch)))
what is a recipe that does not use milk as an ingredient	 (listValue (filter (getProperty (singleton en.recipe) (string !type)) (string requires) (string !=) en.ingredient.milk))
what recipe requires the ingredients of rice pudding	 (listValue (filter (getProperty (singleton en.recipe) (string !type)) (string requires) (string =) (filter (getProperty (singleton en.ingredient) (string !type)) (reverse (string requires)) (string =) en.recipe.rice_pudding)))
what recipes share at least two ingredients	 (listValue (countComparative (getProperty (singleton en.ingredient) (string !type)) (reverse (string requires)) (string >=) (number 2) (getProperty (singleton en.recipe) (string !type))))
show recipes whose posted date is on or before 2004	 (listValue (filter (getProperty (singleton en.recipe) (string !type)) (ensureNumericProperty (string posting_date)) (string <=) (ensureNumericEntity (date 2004 -1 -1))))
show me the total number of recipes	 (listValue (call .size (getProperty (singleton en.recipe) (string !type))))
what is the average cooking time for that dish	 (listValue (aggregate (string avg) (getProperty (getProperty (singleton en.recipe) (string !type)) (string cooking_time))))
when was the recipe for rice pudding posted	 (listValue (getProperty en.recipe.rice_pudding (string posting_date)))
what recipe requires milk or spinach	 (listValue (filter (getProperty (singleton en.recipe) (string !type)) (string requires) (string =) (concat en.ingredient.milk en.ingredient.spinach)))
show me recipe to do a meal for a single person	 (listValue (countSuperlative (getProperty (singleton en.recipe) (string !type)) (string min) (string meal) (getProperty (singleton en.meal) (string !type))))
what meal has more than two recipes	 (listValue (countComparative (getProperty (singleton en.meal) (string !type)) (reverse (string meal)) (string >) (number 2) (getProperty (singleton en.recipe) (string !type))))
which recipes take less time to prepare than to cook rice pudding	 (listValue (filter (getProperty (singleton en.recipe) (string !type)) (ensureNumericProperty (string preparation_time)) (string <) (ensureNumericEntity (getProperty en.recipe.rice_pudding (string cooking_time)))))
what is the total cooking time of the recipe	 (listValue (aggregate (string sum) (getProperty (getProperty (singleton en.recipe) (string !type)) (string cooking_time))))
how many ingredients	 (listValue (call .size (getProperty (singleton en.ingredient) (string !type))))
find a lunch recipe that is prepared with milk	 (listValue (filter (filter (getProperty (singleton en.recipe) (string !type)) (string requires) (string =) en.ingredient.milk) (string meal) (string =) en.meal.lunch))
what recipe takes same or less time to prepare rice pudding	 (listValue (filter (getProperty (singleton en.recipe) (string !type)) (ensureNumericProperty (string preparation_time)) (string <=) (ensureNumericEntity (getProperty en.recipe.rice_pudding (string preparation_time)))))
what is an ingredient found in a recipe that was posted in 2004	 (listValue (filter (getProperty (singleton en.ingredient) (string !type)) (reverse (string requires)) (string =) (filter (getProperty (singleton en.recipe) (string !type)) (string posting_date) (string =) (date 2004 -1 -1))))
show me recipes posted before 2010	 (listValue (filter (getProperty (singleton en.recipe) (string !type)) (ensureNumericProperty (string posting_date)) (string <=) (ensureNumericEntity (concat (date 2004 -1 -1) (date 2010 -1 -1)))))
show me all the recipes posted in 2004	 (listValue (filter (filter (getProperty (singleton en.recipe) (string !type)) (string posting_date) (string =) (date 2004 -1 -1)) (string posting_date) (string =) (date 2004 -1 -1)))
for which meal is that recipe that has milk as one of its ingredients	 (listValue (filter (getProperty (singleton en.meal) (string !type)) (reverse (string meal)) (string =) (filter (getProperty (singleton en.recipe) (string !type)) (string requires) (string =) en.ingredient.milk)))
what recipe makes something for lunch	 (listValue (filter (filter (getProperty (singleton en.recipe) (string !type)) (string meal) (string =) en.meal.lunch) (string meal) (string =) en.meal.lunch))
what recipe cooks in less time than rice pudding	 (listValue (filter (getProperty (singleton en.recipe) (string !type)) (ensureNumericProperty (string cooking_time)) (string >=) (ensureNumericEntity (getProperty en.recipe.rice_pudding (string cooking_time)))))
what recipe takes less time to prep than rice pudding	 (listValue (filter (getProperty (singleton en.recipe) (string !type)) (ensureNumericProperty (string preparation_time)) (string <) (ensureNumericEntity (getProperty en.recipe.rice_pudding (string preparation_time)))))
how long is the average preparation time for the recipe	 (listValue (aggregate (string avg) (getProperty (getProperty (singleton en.recipe) (string !type)) (string preparation_time))))
what recipe was not posted in 2004	 (listValue (filter (getProperty (singleton en.recipe) (string !type)) (string posting_date) (string !=) (date 2004 -1 -1)))
what recipe is designed for more than two meals	 (listValue (countComparative (getProperty (singleton en.recipe) (string !type)) (string meal) (string >) (number 2) (getProperty (singleton en.meal) (string !type))))
what meal is for only one recipe	 (listValue (countComparative (getProperty (singleton en.meal) (string !type)) (reverse (string meal)) (string <) (number 2) (getProperty (singleton en.recipe) (string !type))))
what recipe has milk as an ingredient	 (listValue (filter (filter (getProperty (singleton en.recipe) (string !type)) (string requires) (string =) en.ingredient.milk) (string requires) (string =) en.ingredient.milk))
show me recipes with the longest cooking time	 (listValue (superlative (getProperty (singleton en.recipe) (string !type)) (string max) (ensureNumericProperty (string cooking_time))))
show me recipes that require milk or spinach	 (listValue (filter (getProperty (singleton en.recipe) (string !type)) (string requires) (string =) (concat en.ingredient.milk en.ingredient.spinach)))
show me recipes that have a shorter preparation time than rice pudding	 (listValue (filter (getProperty (singleton en.recipe) (string !type)) (ensureNumericProperty (string preparation_time)) (string <) (ensureNumericEntity (getProperty en.recipe.rice_pudding (string preparation_time)))))
what recipe takes no longer to prepare than rice pudding	 (listValue (filter (getProperty (singleton en.recipe) (string !type)) (ensureNumericProperty (string preparation_time)) (string <=) (ensureNumericEntity (getProperty en.recipe.rice_pudding (string preparation_time)))))
which recipes have at least 2 cuisines	 (listValue (countComparative (getProperty (singleton en.recipe) (string !type)) (string cuisine) (string >=) (number 2)))
what recipes need milk	 (listValue (filter (getProperty (singleton en.recipe) (string !type)) (string requires) (string =) en.ingredient.milk))
a recipe requiring fewer than two ingredients	 (listValue (countComparative (getProperty (singleton en.recipe) (string !type)) (string requires) (string <) (number 2) (getProperty (singleton en.ingredient) (string !type))))
what is the preparation time for that recipe	 (listValue (aggregate (string sum) (getProperty (getProperty (singleton en.recipe) (string !type)) (string preparation_time))))
show me a recipe for the least number of meals	 (listValue (countSuperlative (getProperty (singleton en.recipe) (string !type)) (string min) (string meal) (getProperty (singleton en.meal) (string !type))))
for which meal is the dish rice pudding used	 (listValue (filter (filter (getProperty (singleton en.meal) (string !type)) (reverse (string meal)) (string =) en.recipe.rice_pudding) (reverse (string meal)) (string =) en.recipe.rice_pudding))
what meal can be made by two recipes	 (listValue (countComparative (getProperty (singleton en.meal) (string !type)) (reverse (string meal)) (string =) (number 2) (getProperty (singleton en.recipe) (string !type))))
show me recipes that have a cooking time equal to the preparation time of rice pudding	 (listValue (filter (getProperty (singleton en.recipe) (string !type)) (string cooking_time) (string =) (getProperty en.recipe.rice_pudding (string preparation_time))))
what recipe can make fewer than two meals	 (listValue (countComparative (getProperty (singleton en.recipe) (string !type)) (string meal) (string <) (number 2) (getProperty (singleton en.meal) (string !type))))
show me recipes with preparation times longer than cooking time of rice pudding	 (listValue (filter (getProperty (singleton en.recipe) (string !type)) (ensureNumericProperty (string preparation_time)) (string >) (ensureNumericEntity (getProperty en.recipe.rice_pudding (string cooking_time)))))
how much time it takes to prepare rice pudding	 (listValue (getProperty en.recipe.rice_pudding (string preparation_time)))
what recipe makes the fewest types of cuisine	 (listValue (countSuperlative (getProperty (singleton en.recipe) (string !type)) (string min) (string cuisine)))
what recipe uses milk or spinach as an ingredient	 (listValue (filter (getProperty (singleton en.recipe) (string !type)) (string requires) (string =) (concat en.ingredient.milk en.ingredient.spinach)))
what recipes share the cuisine of rice pudding	 (listValue (filter (getProperty (singleton en.recipe) (string !type)) (string cuisine) (string =) (getProperty en.recipe.rice_pudding (string cuisine))))
show recipes that take at least the preparation time of rice pudding to be done	 (listValue (filter (getProperty (singleton en.recipe) (string !type)) (ensureNumericProperty (string preparation_time)) (string >=) (ensureNumericEntity (getProperty en.recipe.rice_pudding (string preparation_time)))))
what recipe can you prepare in the same or less time than it takes to cook rice pudding	 (listValue (filter (getProperty (singleton en.recipe) (string !type)) (ensureNumericProperty (string preparation_time)) (string <=) (ensureNumericEntity (getProperty en.recipe.rice_pudding (string cooking_time)))))
show me ingredients needed for rice pudding and quiche	 (listValue (filter (getProperty (singleton en.ingredient) (string !type)) (reverse (string requires)) (string =) (concat en.recipe.rice_pudding en.recipe.quiche)))
name the ingredient required by at least two recipes	 (listValue (countComparative (getProperty (singleton en.ingredient) (string !type)) (reverse (string requires)) (string >=) (number 2) (getProperty (singleton en.recipe) (string !type))))
find recipes that were posted before 2004 or 2010	 (listValue (filter (getProperty (singleton en.recipe) (string !type)) (ensureNumericProperty (string posting_date)) (string <) (ensureNumericEntity (concat (date 2004 -1 -1) (date 2010 -1 -1)))))
a recipe which takes longer to cook than the preparation time for rice pudding	 (listValue (filter (getProperty (singleton en.recipe) (string !type)) (ensureNumericProperty (string cooking_time)) (string >) (ensureNumericEntity (getProperty en.recipe.rice_pudding (string preparation_time)))))
the receipe is for two meal	 (listValue (countComparative (getProperty (singleton en.recipe) (string !type)) (string meal) (string =) (number 2) (getProperty (singleton en.meal) (string !type))))
what recipe cooks for equal or less time than rice pudding	 (listValue (filter (getProperty (singleton en.recipe) (string !type)) (ensureNumericProperty (string cooking_time)) (string <=) (ensureNumericEntity (getProperty en.recipe.rice_pudding (string cooking_time)))))
how much time is needed to cook this dish	 (listValue (aggregate (string sum) (getProperty (getProperty (singleton en.recipe) (string !type)) (string cooking_time))))
what recipe has the most ingredients	 (listValue (countSuperlative (getProperty (singleton en.recipe) (string !type)) (string max) (string requires) (getProperty (singleton en.ingredient) (string !type))))
what recipe was posted before rice puddings recipe	 (listValue (filter (getProperty (singleton en.recipe) (string !type)) (ensureNumericProperty (string posting_date)) (string <) (ensureNumericEntity (getProperty en.recipe.rice_pudding (string posting_date)))))
what recipe was posted after rice puddings recipe	 (listValue (filter (getProperty (singleton en.recipe) (string !type)) (ensureNumericProperty (string posting_date)) (string >) (ensureNumericEntity (getProperty en.recipe.rice_pudding (string posting_date)))))
which recipe was posted in 2004	 (listValue (filter (filter (getProperty (singleton en.recipe) (string !type)) (string posting_date) (string =) (date 2004 -1 -1)) (string posting_date) (string =) (date 2004 -1 -1)))
what lunch recipe requires milk	 (listValue (filter (filter (getProperty (singleton en.recipe) (string !type)) (string requires) (string =) en.ingredient.milk) (string meal) (string =) en.meal.lunch))
what is a recipe found in two or more cuisines	 (listValue (countComparative (getProperty (singleton en.recipe) (string !type)) (string cuisine) (string >=) (number 2)))
two cuisine recipe	 (listValue (countComparative (getProperty (singleton en.recipe) (string !type)) (string cuisine) (string =) (number 2)))
what recipe was posted the same date as the rice pudding recipe	 (listValue (filter (getProperty (singleton en.recipe) (string !type)) (string posting_date) (string =) (getProperty en.recipe.rice_pudding (string posting_date))))
recipes for lunch or dinner menus	 (listValue (concat en.meal.lunch en.meal.dinner))
find a recipe that was posted by 2004	 (listValue (filter (getProperty (singleton en.recipe) (string !type)) (ensureNumericProperty (string posting_date)) (string >=) (ensureNumericEntity (date 2004 -1 -1))))
what does the recipe posted in 2004 require	 (listValue (filter (getProperty (singleton en.ingredient) (string !type)) (reverse (string requires)) (string =) (filter (getProperty (singleton en.recipe) (string !type)) (string posting_date) (string =) (date 2004 -1 -1))))
either 2004 or 2010	 (listValue (concat (date 2004 -1 -1) (date 2010 -1 -1)))
show me ingredients required for the most recipes	 (listValue (countSuperlative (getProperty (singleton en.ingredient) (string !type)) (string max) (reverse (string requires)) (getProperty (singleton en.recipe) (string !type))))
find recipe for two meals	 (listValue (countComparative (getProperty (singleton en.recipe) (string !type)) (string meal) (string <=) (number 2) (getProperty (singleton en.meal) (string !type))))
what meal has the least recipes	 (listValue (countSuperlative (getProperty (singleton en.meal) (string !type)) (string min) (reverse (string meal)) (getProperty (singleton en.recipe) (string !type))))
which recipes have two cuisines	 (listValue (countComparative (getProperty (singleton en.recipe) (string !type)) (string cuisine) (string =) (number 2)))
which recipe is for a lunchtime meal	 (listValue (filter (getProperty (singleton en.meal) (string !type)) (reverse (string meal)) (string =) (filter (getProperty (singleton en.recipe) (string !type)) (string meal) (string =) en.meal.lunch)))
recipes that require same time to prepare than rice pudding	 (listValue (filter (getProperty (singleton en.recipe) (string !type)) (string preparation_time) (string =) (getProperty en.recipe.rice_pudding (string preparation_time))))
show me recipes with fewer than two ingredients	 (listValue (countComparative (getProperty (singleton en.recipe) (string !type)) (string requires) (string <) (number 2) (getProperty (singleton en.ingredient) (string !type))))
show me recipes posted in 2004 that use milk	 (listValue (filter (filter (getProperty (singleton en.recipe) (string !type)) (string posting_date) (string =) (date 2004 -1 -1)) (string requires) (string =) en.ingredient.milk))
what ingredients does rice pudding not need	 (listValue (filter (getProperty (singleton en.ingredient) (string !type)) (reverse (string requires)) (string !=) en.recipe.rice_pudding))
what lunch recipe was posted in 2004	 (listValue (filter (filter (getProperty (singleton en.recipe) (string !type)) (string posting_date) (string =) (date 2004 -1 -1)) (string meal) (string =) en.meal.lunch))
which recipe has less cooking time like rice pudding	 (listValue (filter (getProperty (singleton en.recipe) (string !type)) (ensureNumericProperty (string cooking_time)) (string >=) (ensureNumericEntity (getProperty en.recipe.rice_pudding (string cooking_time)))))
a recipe for the fewest types of meals	 (listValue (countSuperlative (getProperty (singleton en.recipe) (string !type)) (string min) (string meal) (getProperty (singleton en.meal) (string !type))))
what recipe requires less prep time than rice pudding	 (listValue (filter (getProperty (singleton en.recipe) (string !type)) (ensureNumericProperty (string preparation_time)) (string <) (ensureNumericEntity (getProperty en.recipe.rice_pudding (string preparation_time)))))
what recipes are cooked in same time as rice pudding	 (listValue (filter (getProperty (singleton en.recipe) (string !type)) (string cooking_time) (string =) (getProperty en.recipe.rice_pudding (string cooking_time))))
which recipe has the least number of cuisines	 (listValue (countSuperlative (getProperty (singleton en.recipe) (string !type)) (string min) (string cuisine)))
show me recipes for the most cuisines	 (listValue (countSuperlative (getProperty (singleton en.recipe) (string !type)) (string max) (string cuisine)))
what is the average cooking time for that recipe	 (listValue (aggregate (string avg) (getProperty (getProperty (singleton en.recipe) (string !type)) (string cooking_time))))
show me a recipe with the same prep time as rice pudding	 (listValue (filter (getProperty (singleton en.recipe) (string !type)) (string preparation_time) (string =) (getProperty en.recipe.rice_pudding (string preparation_time))))
show recipes posted on the same date or later than rice pudding	 (listValue (filter (getProperty (singleton en.recipe) (string !type)) (ensureNumericProperty (string posting_date)) (string >=) (ensureNumericEntity (getProperty en.recipe.rice_pudding (string posting_date)))))
which recipe is intended for the least number of meals	 (listValue (countSuperlative (getProperty (singleton en.recipe) (string !type)) (string min) (string meal) (getProperty (singleton en.meal) (string !type))))
show me recipe that has at least have two cuisine	 (listValue (countComparative (getProperty (singleton en.recipe) (string !type)) (string cuisine) (string >=) (number 2)))
a recipe which posted no sooner than 2004 or 2010	 (listValue (filter (getProperty (singleton en.recipe) (string !type)) (ensureNumericProperty (string posting_date)) (string >=) (ensureNumericEntity (concat (date 2004 -1 -1) (date 2010 -1 -1)))))
what recipe calls for fewer than two ingredients	 (listValue (countComparative (getProperty (singleton en.recipe) (string !type)) (string requires) (string <) (number 2) (getProperty (singleton en.ingredient) (string !type))))
which recipe takes longer to cook than rice pudding	 (listValue (filter (getProperty (singleton en.recipe) (string !type)) (ensureNumericProperty (string cooking_time)) (string >) (ensureNumericEntity (getProperty en.recipe.rice_pudding (string cooking_time)))))
recipe of at most two cuisine	 (listValue (countComparative (getProperty (singleton en.recipe) (string !type)) (string cuisine) (string <=) (number 2)))
what recipe calls for the fewest ingredients	 (listValue (countSuperlative (getProperty (singleton en.recipe) (string !type)) (string min) (string requires) (getProperty (singleton en.ingredient) (string !type))))
when was rice pudding recipe posted	 (listValue (getProperty en.recipe.rice_pudding (string posting_date)))
what recipes cooking time is greater than that of rice pudding	 (listValue (filter (getProperty (singleton en.recipe) (string !type)) (ensureNumericProperty (string cooking_time)) (string >) (ensureNumericEntity (getProperty en.recipe.rice_pudding (string cooking_time)))))
show me ingredients required by at least two recipes	 (listValue (countComparative (getProperty (singleton en.ingredient) (string !type)) (reverse (string requires)) (string >=) (number 2) (getProperty (singleton en.recipe) (string !type))))
which recipe has a cooking time as that of rice pudding	 (listValue (filter (getProperty (singleton en.recipe) (string !type)) (ensureNumericProperty (string cooking_time)) (string >=) (ensureNumericEntity (getProperty en.recipe.rice_pudding (string preparation_time)))))
which recipes can make two meals	 (listValue (countComparative (getProperty (singleton en.recipe) (string !type)) (string meal) (string =) (number 2) (getProperty (singleton en.meal) (string !type))))
what recipes preparation time is lesser than the cooking time of rice pudding	 (listValue (filter (getProperty (singleton en.recipe) (string !type)) (ensureNumericProperty (string preparation_time)) (string <) (ensureNumericEntity (getProperty en.recipe.rice_pudding (string cooking_time)))))
which recipe was posted during 2004	 (listValue (filter (getProperty (singleton en.recipe) (string !type)) (ensureNumericProperty (string posting_date)) (string <=) (ensureNumericEntity (date 2004 -1 -1))))
which recipe falls under the least kinds of cuisine	 (listValue (countSuperlative (getProperty (singleton en.recipe) (string !type)) (string min) (string cuisine)))
what ingredient is used by two recipes	 (listValue (countComparative (getProperty (singleton en.ingredient) (string !type)) (reverse (string requires)) (string =) (number 2) (getProperty (singleton en.recipe) (string !type))))
what recipe calling for milk was posted in 2004	 (listValue (filter (filter (getProperty (singleton en.recipe) (string !type)) (string posting_date) (string =) (date 2004 -1 -1)) (string requires) (string =) en.ingredient.milk))
what recipe posted in 2004 makes a lunch meal	 (listValue (filter (filter (getProperty (singleton en.recipe) (string !type)) (string posting_date) (string =) (date 2004 -1 -1)) (string meal) (string =) en.meal.lunch))
ingredient of two recipes	 (listValue (countComparative (getProperty (singleton en.ingredient) (string !type)) (reverse (string requires)) (string =) (number 2) (getProperty (singleton en.recipe) (string !type))))
what meal has two or less recipes	 (listValue (countComparative (getProperty (singleton en.meal) (string !type)) (reverse (string meal)) (string <=) (number 2) (getProperty (singleton en.recipe) (string !type))))
what meal doesnt call for rice pudding	 (listValue (filter (getProperty (singleton en.meal) (string !type)) (reverse (string meal)) (string !=) en.recipe.rice_pudding))
which ingredient is needed in less than two recipes 	 (listValue (countComparative (getProperty (singleton en.ingredient) (string !type)) (reverse (string requires)) (string <) (number 2) (getProperty (singleton en.recipe) (string !type))))
show me the ingredients for rice pudding	 (listValue (filter (getProperty (singleton en.ingredient) (string !type)) (reverse (string requires)) (string =) en.recipe.rice_pudding))
what food items are needed to make rice pudding	 (listValue (filter (getProperty (singleton en.ingredient) (string !type)) (reverse (string requires)) (string =) en.recipe.rice_pudding))
what recipe was posted the earliest	 (listValue (superlative (getProperty (singleton en.recipe) (string !type)) (string min) (ensureNumericProperty (string posting_date))))
what is the average time needed for the preparation of the dish	 (listValue (aggregate (string avg) (getProperty (getProperty (singleton en.recipe) (string !type)) (string cooking_time))))
what recipe requires at the least two ingredients	 (listValue (countComparative (getProperty (singleton en.recipe) (string !type)) (string requires) (string >=) (number 2) (getProperty (singleton en.ingredient) (string !type))))
what recipes can be prepared faster than rice pudding	 (listValue (filter (getProperty (singleton en.recipe) (string !type)) (ensureNumericProperty (string preparation_time)) (string <) (ensureNumericEntity (getProperty en.recipe.rice_pudding (string cooking_time)))))
which meal has two or more recipes	 (listValue (countComparative (getProperty (singleton en.meal) (string !type)) (reverse (string meal)) (string >=) (number 2) (getProperty (singleton en.recipe) (string !type))))
which recipes have three or more cuisine	 (listValue (countComparative (getProperty (singleton en.recipe) (string !type)) (string cuisine) (string >) (number 2)))
what is the cook time for rice pudding	 (listValue (getProperty en.recipe.rice_pudding (string cooking_time)))
what is the total number of recipes	 (listValue (call .size (getProperty (singleton en.recipe) (string !type))))
what is the usual time required to finish the recipe	 (listValue (aggregate (string avg) (getProperty (getProperty (singleton en.recipe) (string !type)) (string preparation_time))))
what ingredient is used for the least amount of recipes	 (listValue (countSuperlative (getProperty (singleton en.ingredient) (string !type)) (string min) (reverse (string requires)) (getProperty (singleton en.recipe) (string !type))))
what recipe is for a meal for two	 (listValue (countComparative (getProperty (singleton en.meal) (string !type)) (reverse (string meal)) (string >=) (number 2) (getProperty (singleton en.recipe) (string !type))))
what recipes dont call for milk	 (listValue (filter (getProperty (singleton en.recipe) (string !type)) (string requires) (string !=) en.ingredient.milk))
what meal has over two recipes	 (listValue (countComparative (getProperty (singleton en.meal) (string !type)) (reverse (string meal)) (string >) (number 2) (getProperty (singleton en.recipe) (string !type))))
recipe of less than two meal	 (listValue (countComparative (getProperty (singleton en.recipe) (string !type)) (string meal) (string <) (number 2) (getProperty (singleton en.meal) (string !type))))
are there any recipes which were posted twice in 2004	 (listValue (filter (filter (getProperty (singleton en.recipe) (string !type)) (string posting_date) (string =) (date 2004 -1 -1)) (string posting_date) (string =) (date 2004 -1 -1)))
to which cuisine does rice pudding belong	 (listValue (getProperty en.recipe.rice_pudding (string cuisine)))
what recipes comes under less than three cuisine	 (listValue (countComparative (getProperty (singleton en.recipe) (string !type)) (string cuisine) (string <=) (number 2)))
which recipes were posted after 2004 or 2010	 (listValue (filter (getProperty (singleton en.recipe) (string !type)) (ensureNumericProperty (string posting_date)) (string >) (ensureNumericEntity (concat (date 2004 -1 -1) (date 2010 -1 -1)))))
find a meal with two recipes	 (listValue (countComparative (getProperty (singleton en.meal) (string !type)) (reverse (string meal)) (string =) (number 2) (getProperty (singleton en.recipe) (string !type))))
recipes posted till 2004	 (listValue (filter (getProperty (singleton en.recipe) (string !type)) (ensureNumericProperty (string posting_date)) (string <=) (ensureNumericEntity (date 2004 -1 -1))))
find recipes posted after 2004	 (listValue (filter (getProperty (singleton en.recipe) (string !type)) (ensureNumericProperty (string posting_date)) (string >) (ensureNumericEntity (date 2004 -1 -1))))
recipe cooked in preparation time of rice pudding or more	 (listValue (filter (getProperty (singleton en.recipe) (string !type)) (ensureNumericProperty (string cooking_time)) (string >=) (ensureNumericEntity (getProperty en.recipe.rice_pudding (string preparation_time)))))
show me the recipe that has the shortest cooking time	 (listValue (superlative (getProperty (singleton en.recipe) (string !type)) (string min) (ensureNumericProperty (string cooking_time))))
what is a recipe using milk or spinach as an ingredient	 (listValue (concat en.ingredient.milk en.ingredient.spinach))
what recipe has a cuisine including rice pudding	 (listValue (filter (getProperty (singleton en.recipe) (string !type)) (string cuisine) (string =) (getProperty en.recipe.rice_pudding (string cuisine))))
show me recipes that require less than two ingredients	 (listValue (countComparative (getProperty (singleton en.ingredient) (string !type)) (reverse (string requires)) (string <) (number 2) (getProperty (singleton en.recipe) (string !type))))
show me recipes posted after 2004	 (listValue (filter (getProperty (singleton en.recipe) (string !type)) (ensureNumericProperty (string posting_date)) (string >) (ensureNumericEntity (concat (date 2004 -1 -1) (date 2010 -1 -1)))))
which ingredient is needed in more than one recipes	 (listValue (countComparative (getProperty (singleton en.ingredient) (string !type)) (reverse (string requires)) (string >=) (number 2) (getProperty (singleton en.recipe) (string !type))))
a recipe which takes at least as long to cook as rice pudding	 (listValue (filter (getProperty (singleton en.recipe) (string !type)) (ensureNumericProperty (string cooking_time)) (string >=) (ensureNumericEntity (getProperty en.recipe.rice_pudding (string cooking_time)))))
what recipe takes most time to cook	 (listValue (superlative (getProperty (singleton en.recipe) (string !type)) (string max) (ensureNumericProperty (string cooking_time))))
which recipe needs more time than rice pudding preparation	 (listValue (filter (getProperty (singleton en.recipe) (string !type)) (ensureNumericProperty (string preparation_time)) (string >) (ensureNumericEntity (getProperty en.recipe.rice_pudding (string preparation_time)))))
show me recipes requiring milk	 (listValue (filter (filter (getProperty (singleton en.recipe) (string !type)) (string requires) (string =) en.ingredient.milk) (string requires) (string =) en.ingredient.milk))
show me lunch recipes that posted in 2004	 (listValue (filter (filter (getProperty (singleton en.recipe) (string !type)) (string posting_date) (string =) (date 2004 -1 -1)) (string meal) (string =) en.meal.lunch))
what recipes cooking time is at the greatest the cooking time of rice pudding	 (listValue (filter (getProperty (singleton en.recipe) (string !type)) (ensureNumericProperty (string cooking_time)) (string <=) (ensureNumericEntity (getProperty en.recipe.rice_pudding (string cooking_time)))))
what are the recipe that at most use two ingredients 	 (listValue (countComparative (getProperty (singleton en.recipe) (string !type)) (string requires) (string <=) (number 2) (getProperty (singleton en.ingredient) (string !type))))
what meal has quiche and rice pudding	 (listValue (filter (getProperty (singleton en.meal) (string !type)) (reverse (string meal)) (string =) (concat en.recipe.rice_pudding en.recipe.quiche)))
recipe with posting date not after posting date of rice pudding	 (listValue (filter (getProperty (singleton en.recipe) (string !type)) (ensureNumericProperty (string posting_date)) (string <=) (ensureNumericEntity (getProperty en.recipe.rice_pudding (string posting_date)))))
show me recipe which take as much time as rice pudding	 (listValue (filter (getProperty (singleton en.recipe) (string !type)) (string preparation_time) (string =) (getProperty en.recipe.rice_pudding (string cooking_time))))
recipe for only one meal	 (listValue (countComparative (getProperty (singleton en.recipe) (string !type)) (string meal) (string <) (number 2) (getProperty (singleton en.meal) (string !type))))
what ingredient is found in rice pudding	 (listValue (filter (getProperty (singleton en.recipe) (string !type)) (string requires) (string =) (filter (getProperty (singleton en.ingredient) (string !type)) (reverse (string requires)) (string =) en.recipe.rice_pudding)))
find a recipe that needs milk for its preparation	 (listValue (filter (filter (getProperty (singleton en.recipe) (string !type)) (string requires) (string =) en.ingredient.milk) (string requires) (string =) en.ingredient.milk))
what recipes require the same time or than rice pudding	 (listValue (filter (getProperty (singleton en.recipe) (string !type)) (ensureNumericProperty (string cooking_time)) (string >=) (ensureNumericEntity (getProperty en.recipe.rice_pudding (string cooking_time)))))
what ingredients do lunch recipes call for	 (listValue (filter (getProperty (singleton en.ingredient) (string !type)) (reverse (string requires)) (string =) (filter (getProperty (singleton en.recipe) (string !type)) (string meal) (string =) en.meal.lunch)))
for what meal is rice pudding used	 (listValue (filter (filter (getProperty (singleton en.meal) (string !type)) (reverse (string meal)) (string =) en.recipe.rice_pudding) (reverse (string meal)) (string =) en.recipe.rice_pudding))
which recipes are intended for lunch or dinner	 (listValue (filter (getProperty (singleton en.recipe) (string !type)) (string meal) (string =) (concat en.meal.lunch en.meal.dinner)))
what recipes require no more than two ingredients	 (listValue (countComparative (getProperty (singleton en.recipe) (string !type)) (string requires) (string <=) (number 2) (getProperty (singleton en.ingredient) (string !type))))
how many recipes	 (listValue (call .size (getProperty (singleton en.recipe) (string !type))))
show me a recipe that requires only two ingredients	 (listValue (countComparative (getProperty (singleton en.recipe) (string !type)) (string requires) (string =) (number 2) (getProperty (singleton en.ingredient) (string !type))))
show me ingredients required by recipes that require milk	 (listValue (filter (getProperty (singleton en.ingredient) (string !type)) (reverse (string requires)) (string =) (filter (getProperty (singleton en.recipe) (string !type)) (string requires) (string =) en.ingredient.milk)))
what recipes preparation time is no more than the cooking time of rice pudding	 (listValue (filter (getProperty (singleton en.recipe) (string !type)) (ensureNumericProperty (string preparation_time)) (string <=) (ensureNumericEntity (getProperty en.recipe.rice_pudding (string cooking_time)))))
show me recipes that use two ingredients or less	 (listValue (countComparative (getProperty (singleton en.recipe) (string !type)) (string requires) (string <=) (number 2) (getProperty (singleton en.ingredient) (string !type))))
what recipes need milk and is posted in 2004	 (listValue (filter (filter (getProperty (singleton en.recipe) (string !type)) (string requires) (string =) en.ingredient.milk) (string posting_date) (string =) (date 2004 -1 -1)))
show me recipes for lunch or supper	 (listValue (filter (getProperty (singleton en.recipe) (string !type)) (string meal) (string =) (concat en.meal.lunch en.meal.dinner)))
name the ingredient in most recipes	 (listValue (countSuperlative (getProperty (singleton en.ingredient) (string !type)) (string max) (reverse (string requires)) (getProperty (singleton en.recipe) (string !type))))
show me recipes that require the cooking time of rice pudding	 (listValue (filter (getProperty (singleton en.recipe) (string !type)) (string cooking_time) (string =) (getProperty en.recipe.rice_pudding (string cooking_time))))
show me recipes posted in 2004 and 2010	 (listValue (filter (getProperty (singleton en.recipe) (string !type)) (string posting_date) (string =) (concat (date 2004 -1 -1) (date 2010 -1 -1))))
recipe prepared in more time than cooking time of rice pudding	 (listValue (filter (getProperty (singleton en.recipe) (string !type)) (ensureNumericProperty (string preparation_time)) (string >) (ensureNumericEntity (getProperty en.recipe.rice_pudding (string cooking_time)))))
which recipe s cooking time is equal to that of rice pudding	 (listValue (filter (getProperty (singleton en.recipe) (string !type)) (ensureNumericProperty (string preparation_time)) (string <=) (ensureNumericEntity (getProperty en.recipe.rice_pudding (string cooking_time)))))
show me lunch recipes that need milk	 (listValue (filter (filter (getProperty (singleton en.recipe) (string !type)) (string requires) (string =) en.ingredient.milk) (string meal) (string =) en.meal.lunch))
what meals have two recipes	 (listValue (countComparative (getProperty (singleton en.meal) (string !type)) (reverse (string meal)) (string =) (number 2) (getProperty (singleton en.recipe) (string !type))))
what are the recipes that are made with milk	 (listValue (filter (getProperty (singleton en.recipe) (string !type)) (string requires) (string =) en.ingredient.milk))
which recipe is used for the most meals	 (listValue (countSuperlative (getProperty (singleton en.recipe) (string !type)) (string max) (string meal) (getProperty (singleton en.meal) (string !type))))
how long does rice pudding take to cook	 (listValue (getProperty en.recipe.rice_pudding (string cooking_time)))
find recipes posted in 2004 or 2010	 (listValue (filter (getProperty (singleton en.recipe) (string !type)) (string posting_date) (string =) (concat (date 2004 -1 -1) (date 2010 -1 -1))))
show me meals with fewer than two recipes	 (listValue (countComparative (getProperty (singleton en.meal) (string !type)) (reverse (string meal)) (string <) (number 2) (getProperty (singleton en.recipe) (string !type))))
a recipe requiring the fewest ingredients	 (listValue (countSuperlative (getProperty (singleton en.recipe) (string !type)) (string min) (string requires) (getProperty (singleton en.ingredient) (string !type))))
what recipe was posted before or on the same day as rice pudding	 (listValue (filter (getProperty (singleton en.recipe) (string !type)) (ensureNumericProperty (string posting_date)) (string <=) (ensureNumericEntity (getProperty en.recipe.rice_pudding (string posting_date)))))
what meal can be made by the recipe posted in 2004	 (listValue (filter (getProperty (singleton en.meal) (string !type)) (reverse (string meal)) (string =) (filter (getProperty (singleton en.recipe) (string !type)) (string posting_date) (string =) (date 2004 -1 -1))))
show me recipes for lunch posted in 2004	 (listValue (filter (filter (getProperty (singleton en.recipe) (string !type)) (string meal) (string =) en.meal.lunch) (string posting_date) (string =) (date 2004 -1 -1)))
show me recipes posted no earlier than 2004	 (listValue (filter (getProperty (singleton en.recipe) (string !type)) (ensureNumericProperty (string posting_date)) (string >=) (ensureNumericEntity (date 2004 -1 -1))))
show me recipes that take the same time to prepare as rice pudding	 (listValue (filter (getProperty (singleton en.recipe) (string !type)) (string preparation_time) (string =) (getProperty en.recipe.rice_pudding (string preparation_time))))
what meal has maximum recipes	 (listValue (countComparative (getProperty (singleton en.meal) (string !type)) (reverse (string meal)) (string <=) (number 2) (getProperty (singleton en.recipe) (string !type))))
what recipe posted in 2004 requires milk as an ingredient	 (listValue (filter (filter (getProperty (singleton en.recipe) (string !type)) (string posting_date) (string =) (date 2004 -1 -1)) (string requires) (string =) en.ingredient.milk))
which recipe needs more than two ingredients	 (listValue (countComparative (getProperty (singleton en.recipe) (string !type)) (string requires) (string >) (number 2) (getProperty (singleton en.ingredient) (string !type))))
what recipes are for less than two meals	 (listValue (countComparative (getProperty (singleton en.recipe) (string !type)) (string meal) (string <) (number 2) (getProperty (singleton en.meal) (string !type))))
show me recipes requiring the ingredient milk	 (listValue (filter (getProperty (singleton en.ingredient) (string !type)) (reverse (string requires)) (string =) (filter (getProperty (singleton en.recipe) (string !type)) (string requires) (string =) en.ingredient.milk)))
show me recipes with two ingedients	 (listValue (countComparative (getProperty (singleton en.recipe) (string !type)) (string cuisine) (string =) (number 2)))
ingredient required by recipe whose posting date is 2004	 (listValue (filter (getProperty (singleton en.ingredient) (string !type)) (reverse (string requires)) (string =) (filter (getProperty (singleton en.recipe) (string !type)) (string posting_date) (string =) (date 2004 -1 -1))))
when was the rice pudding recipe posted	 (listValue (getProperty en.recipe.rice_pudding (string posting_date)))
which recipes require at least two ingredients	 (listValue (countComparative (getProperty (singleton en.recipe) (string !type)) (string requires) (string >=) (number 2) (getProperty (singleton en.ingredient) (string !type))))
what recipes have a cooking time that is at least as long as rice puddings preparation time	 (listValue (filter (getProperty (singleton en.recipe) (string !type)) (ensureNumericProperty (string cooking_time)) (string >=) (ensureNumericEntity (getProperty en.recipe.rice_pudding (string preparation_time)))))
which recipes take longer to cook than rice pudding	 (listValue (filter (getProperty (singleton en.recipe) (string !type)) (ensureNumericProperty (string preparation_time)) (string >) (ensureNumericEntity (getProperty en.recipe.rice_pudding (string cooking_time)))))
what meals are recipes for lunch for	 (listValue (filter (getProperty (singleton en.meal) (string !type)) (reverse (string meal)) (string =) (filter (getProperty (singleton en.recipe) (string !type)) (string meal) (string =) en.meal.lunch)))
which recipe uses milk as an ingredient	 (listValue (filter (getProperty (singleton en.recipe) (string !type)) (string requires) (string =) en.ingredient.milk))
what recipes ingredient does this lunch require	 (listValue (filter (getProperty (singleton en.ingredient) (string !type)) (reverse (string requires)) (string =) (filter (getProperty (singleton en.recipe) (string !type)) (string meal) (string =) en.meal.lunch)))
how many total recipes are there	 (listValue (call .size (getProperty (singleton en.recipe) (string !type))))
which recipe takes the maximum preparation time	 (listValue (superlative (getProperty (singleton en.recipe) (string !type)) (string max) (ensureNumericProperty (string cooking_time))))
which recipe has the most number of cuisine	 (listValue (countSuperlative (getProperty (singleton en.recipe) (string !type)) (string max) (string cuisine)))
show me recipes that take the same amount of time to prepare as rice pudding does to cook	 (listValue (filter (getProperty (singleton en.recipe) (string !type)) (string preparation_time) (string =) (getProperty en.recipe.rice_pudding (string cooking_time))))
for what meal is rice pudding	 (listValue (filter (filter (getProperty (singleton en.meal) (string !type)) (reverse (string meal)) (string =) en.recipe.rice_pudding) (reverse (string meal)) (string =) en.recipe.rice_pudding))
for what meal is rice pudding or quiche	 (listValue (filter (getProperty (singleton en.meal) (string !type)) (reverse (string meal)) (string =) (concat en.recipe.rice_pudding en.recipe.quiche)))
show me recipes with cooking time equal to rice pudding	 (listValue (filter (getProperty (singleton en.recipe) (string !type)) (string cooking_time) (string =) (getProperty en.recipe.rice_pudding (string cooking_time))))
show me recipes for more than two meals	 (listValue (countComparative (getProperty (singleton en.recipe) (string !type)) (string meal) (string >) (number 2) (getProperty (singleton en.meal) (string !type))))
show me recipes from the same cuisine as rice pudding	 (listValue (filter (getProperty (singleton en.recipe) (string !type)) (string cuisine) (string =) (getProperty en.recipe.rice_pudding (string cuisine))))
what ingredients go in rice pudding	 (listValue (filter (filter (getProperty (singleton en.ingredient) (string !type)) (reverse (string requires)) (string =) en.recipe.rice_pudding) (reverse (string requires)) (string =) en.recipe.rice_pudding))
what recipe needs spinach or milk for its preparation	 (listValue (filter (getProperty (singleton en.recipe) (string !type)) (string requires) (string =) (concat en.ingredient.milk en.ingredient.spinach)))
lunch recipes posted in 2004	 (listValue (filter (filter (getProperty (singleton en.recipe) (string !type)) (string meal) (string =) en.meal.lunch) (string posting_date) (string =) (date 2004 -1 -1)))
show the first recipe posted	 (listValue (superlative (getProperty (singleton en.recipe) (string !type)) (string min) (ensureNumericProperty (string posting_date))))
what recipes posting date is lesser than that of rice pudding	 (listValue (filter (getProperty (singleton en.recipe) (string !type)) (ensureNumericProperty (string posting_date)) (string <) (ensureNumericEntity (getProperty en.recipe.rice_pudding (string posting_date)))))
show recipes posted before rice pudding	 (listValue (filter (getProperty (singleton en.recipe) (string !type)) (ensureNumericProperty (string posting_date)) (string <) (ensureNumericEntity (getProperty en.recipe.rice_pudding (string posting_date)))))
show me two recipes for a meal	 (listValue (countComparative (getProperty (singleton en.meal) (string !type)) (reverse (string meal)) (string =) (number 2) (getProperty (singleton en.recipe) (string !type))))
what is the total time required for preparing the dish	 (listValue (aggregate (string sum) (getProperty (getProperty (singleton en.recipe) (string !type)) (string preparation_time))))
show me recipes that require cooking time thats more than rice pudding	 (listValue (filter (getProperty (singleton en.recipe) (string !type)) (ensureNumericProperty (string cooking_time)) (string >) (ensureNumericEntity (getProperty en.recipe.rice_pudding (string cooking_time)))))
which recipe is posted after the posting date of rice pudding	 (listValue (filter (getProperty (singleton en.recipe) (string !type)) (ensureNumericProperty (string posting_date)) (string >) (ensureNumericEntity (getProperty en.recipe.rice_pudding (string posting_date)))))
which recipe was posted most recently	 (listValue (superlative (getProperty (singleton en.recipe) (string !type)) (string max) (ensureNumericProperty (string posting_date))))
which recipe has the same cooking time of rice pudding	 (listValue (filter (getProperty (singleton en.recipe) (string !type)) (string preparation_time) (string =) (getProperty en.recipe.rice_pudding (string cooking_time))))
what recipes preparation time is at least that of rice pudding	 (listValue (filter (getProperty (singleton en.recipe) (string !type)) (ensureNumericProperty (string preparation_time)) (string >=) (ensureNumericEntity (getProperty en.recipe.rice_pudding (string preparation_time)))))
recipes for rice pudding or quice	 (listValue (concat en.recipe.rice_pudding en.recipe.quiche))
which recipes have the most number of meals	 (listValue (countSuperlative (getProperty (singleton en.recipe) (string !type)) (string max) (string meal) (getProperty (singleton en.meal) (string !type))))
name ingredients that is not required for rice pudding	 (listValue (filter (getProperty (singleton en.ingredient) (string !type)) (reverse (string requires)) (string !=) en.recipe.rice_pudding))
name the recipe with a cooking time with at least the cooking time of rice pudding	 (listValue (filter (getProperty (singleton en.recipe) (string !type)) (ensureNumericProperty (string cooking_time)) (string >=) (ensureNumericEntity (getProperty en.recipe.rice_pudding (string cooking_time)))))
show me all the recipes posted after 2010	 (listValue (filter (getProperty (singleton en.recipe) (string !type)) (ensureNumericProperty (string posting_date)) (string >) (ensureNumericEntity (concat (date 2004 -1 -1) (date 2010 -1 -1)))))
show me recipes that involve two cuisines	 (listValue (countComparative (getProperty (singleton en.recipe) (string !type)) (string cuisine) (string =) (number 2)))
which recipe has a prep time no greater than the prep time for rice pudding	 (listValue (filter (getProperty (singleton en.recipe) (string !type)) (ensureNumericProperty (string preparation_time)) (string <=) (ensureNumericEntity (getProperty en.recipe.rice_pudding (string preparation_time)))))
show me recipes that has milk as one of its ingredients	 (listValue (filter (getProperty (singleton en.recipe) (string !type)) (string requires) (string =) en.ingredient.milk))
what is a recipe that takes no more time to cook than rice pudding	 (listValue (filter (getProperty (singleton en.recipe) (string !type)) (ensureNumericProperty (string cooking_time)) (string <=) (ensureNumericEntity (getProperty en.recipe.rice_pudding (string cooking_time)))))
what ingredient is most used	 (listValue (countSuperlative (getProperty (singleton en.ingredient) (string !type)) (string max) (reverse (string requires)) (getProperty (singleton en.recipe) (string !type))))
what is a meal other than rice pudding	 (listValue (filter (getProperty (singleton en.meal) (string !type)) (reverse (string meal)) (string !=) en.recipe.rice_pudding))
which is the food item that is needed in two recipes	 (listValue (countComparative (getProperty (singleton en.ingredient) (string !type)) (reverse (string requires)) (string =) (number 2) (getProperty (singleton en.recipe) (string !type))))
which recipe requires the same ingredient as rice pudding	 (listValue (filter (getProperty (singleton en.recipe) (string !type)) (string requires) (string =) (filter (getProperty (singleton en.ingredient) (string !type)) (reverse (string requires)) (string =) en.recipe.rice_pudding)))
what recipe was posted during 2004	 (listValue (filter (getProperty (singleton en.recipe) (string !type)) (string posting_date) (string =) (date 2004 -1 -1)))
what is an ingredient found in rice pudding	 (listValue (filter (getProperty (singleton en.ingredient) (string !type)) (reverse (string requires)) (string =) en.recipe.rice_pudding))
which is the last posted recipe	 (listValue (superlative (getProperty (singleton en.recipe) (string !type)) (string max) (ensureNumericProperty (string posting_date))))
show me meal recipes including rice pudding	 (listValue (filter (getProperty (singleton en.recipe) (string !type)) (string meal) (string =) (filter (getProperty (singleton en.meal) (string !type)) (reverse (string meal)) (string =) en.recipe.rice_pudding)))
what recipes cooking time is the preparation time of rice pudding	 (listValue (filter (getProperty (singleton en.recipe) (string !type)) (string cooking_time) (string =) (getProperty en.recipe.rice_pudding (string preparation_time))))
what recipe makes two types of cuisine	 (listValue (countComparative (getProperty (singleton en.recipe) (string !type)) (string cuisine) (string =) (number 2)))
what recipe has two or more types of cuisine	 (listValue (countComparative (getProperty (singleton en.recipe) (string !type)) (string cuisine) (string >=) (number 2)))
what is the cooking time of rice pudding	 (listValue (getProperty en.recipe.rice_pudding (string cooking_time)))
what ingrediant is used in the fewest recipes	 (listValue (countSuperlative (getProperty (singleton en.ingredient) (string !type)) (string min) (reverse (string requires)) (getProperty (singleton en.recipe) (string !type))))
show me recipes with preparation time equal to or longer than rice pudding	 (listValue (filter (getProperty (singleton en.recipe) (string !type)) (ensureNumericProperty (string preparation_time)) (string >=) (ensureNumericEntity (getProperty en.recipe.rice_pudding (string cooking_time)))))
what recipe calls for over two ingredients	 (listValue (countComparative (getProperty (singleton en.recipe) (string !type)) (string requires) (string >) (number 2) (getProperty (singleton en.ingredient) (string !type))))
which recipe was posted on the same date as that of rice pudding	 (listValue (filter (getProperty (singleton en.recipe) (string !type)) (string posting_date) (string =) (getProperty en.recipe.rice_pudding (string posting_date))))
how long does the recipe take to prep	 (listValue (aggregate (string sum) (getProperty (getProperty (singleton en.recipe) (string !type)) (string preparation_time))))
what ingredient is in than two recipes	 (listValue (countComparative (getProperty (singleton en.ingredient) (string !type)) (reverse (string requires)) (string >) (number 2) (getProperty (singleton en.recipe) (string !type))))
name ingredients used only in one or two recipes	 (listValue (countComparative (getProperty (singleton en.ingredient) (string !type)) (reverse (string requires)) (string <=) (number 2) (getProperty (singleton en.recipe) (string !type))))
what recipe has over two types of cuisine	 (listValue (countComparative (getProperty (singleton en.recipe) (string !type)) (string cuisine) (string >) (number 2)))
find a recipe which has a longer cooking time than rice pudding	 (listValue (filter (getProperty (singleton en.recipe) (string !type)) (ensureNumericProperty (string cooking_time)) (string >) (ensureNumericEntity (getProperty en.recipe.rice_pudding (string preparation_time)))))
what recipe needs milk and is for lunch	 (listValue (filter (filter (getProperty (singleton en.recipe) (string !type)) (string requires) (string =) en.ingredient.milk) (string meal) (string =) en.meal.lunch))
what meals does rice pudding not go with	 (listValue (filter (getProperty (singleton en.meal) (string !type)) (reverse (string meal)) (string !=) en.recipe.rice_pudding))
what recipe has a cook time less than the cook time of rice pudding	 (listValue (filter (getProperty (singleton en.recipe) (string !type)) (ensureNumericProperty (string cooking_time)) (string <) (ensureNumericEntity (getProperty en.recipe.rice_pudding (string cooking_time)))))
show me the recipe that has the largest preperation time	 (listValue (superlative (getProperty (singleton en.recipe) (string !type)) (string max) (ensureNumericProperty (string preparation_time))))
which recipe was posted the earliest	 (listValue (superlative (getProperty (singleton en.recipe) (string !type)) (string min) (ensureNumericProperty (string posting_date))))
what is a recipe that is for more than two different meals	 (listValue (countComparative (getProperty (singleton en.recipe) (string !type)) (string meal) (string >) (number 2) (getProperty (singleton en.meal) (string !type))))
find the lunch recipes posted in 2004	 (listValue (filter (filter (getProperty (singleton en.recipe) (string !type)) (string posting_date) (string =) (date 2004 -1 -1)) (string meal) (string =) en.meal.lunch))
a recipe with milk as an ingredient	 (listValue (filter (getProperty (singleton en.ingredient) (string !type)) (reverse (string requires)) (string =) (filter (getProperty (singleton en.recipe) (string !type)) (string requires) (string =) en.ingredient.milk)))
what recipe was posted before 2004	 (listValue (filter (getProperty (singleton en.recipe) (string !type)) (ensureNumericProperty (string posting_date)) (string <) (ensureNumericEntity (date 2004 -1 -1))))
what ingredient is required in only one recipe	 (listValue (countComparative (getProperty (singleton en.ingredient) (string !type)) (reverse (string requires)) (string <) (number 2) (getProperty (singleton en.recipe) (string !type))))
what ingredient is required in either rice pudding or quiche	 (listValue (filter (getProperty (singleton en.ingredient) (string !type)) (reverse (string requires)) (string =) (concat en.recipe.rice_pudding en.recipe.quiche)))
what are the ingredients needed for recipes posted in 2004	 (listValue (filter (getProperty (singleton en.ingredient) (string !type)) (reverse (string requires)) (string =) (filter (getProperty (singleton en.recipe) (string !type)) (string posting_date) (string =) (date 2004 -1 -1))))
how many meals do we have everyday	 (listValue (call .size (getProperty (singleton en.meal) (string !type))))
whats the average preparation time of a recipe	 (listValue (aggregate (string avg) (getProperty (getProperty (singleton en.recipe) (string !type)) (string preparation_time))))
show me recipes posted before rice pudding	 (listValue (filter (getProperty (singleton en.recipe) (string !type)) (ensureNumericProperty (string posting_date)) (string <) (ensureNumericEntity (getProperty en.recipe.rice_pudding (string posting_date)))))
show me recipes posted in 2004	 (listValue (filter (getProperty (singleton en.recipe) (string !type)) (string posting_date) (string =) (date 2004 -1 -1)))
what are the recipes for lunch	 (listValue (filter (filter (getProperty (singleton en.recipe) (string !type)) (string meal) (string =) en.meal.lunch) (string meal) (string =) en.meal.lunch))
what recipes posting date is 2004	 (listValue (filter (filter (getProperty (singleton en.recipe) (string !type)) (string posting_date) (string =) (date 2004 -1 -1)) (string posting_date) (string =) (date 2004 -1 -1)))
what lunch recipe uses milk as an ingredient	 (listValue (filter (filter (getProperty (singleton en.recipe) (string !type)) (string meal) (string =) en.meal.lunch) (string requires) (string =) en.ingredient.milk))
how long does this recipe take to cook	 (listValue (aggregate (string sum) (getProperty (getProperty (singleton en.recipe) (string !type)) (string cooking_time))))
find a recipe that is good for lunch or dinner	 (listValue (filter (getProperty (singleton en.recipe) (string !type)) (string meal) (string =) (concat en.meal.lunch en.meal.dinner)))
what meal is the recipe posted in 2004	 (listValue (filter (getProperty (singleton en.meal) (string !type)) (reverse (string meal)) (string =) (filter (getProperty (singleton en.recipe) (string !type)) (string posting_date) (string =) (date 2004 -1 -1))))
which recipe has the least amount of prep time	 (listValue (superlative (getProperty (singleton en.recipe) (string !type)) (string min) (ensureNumericProperty (string preparation_time))))
what recipes posting date is at the greatest in 2004	 (listValue (filter (getProperty (singleton en.recipe) (string !type)) (ensureNumericProperty (string posting_date)) (string <=) (ensureNumericEntity (date 2004 -1 -1))))
what meal most recipes made for	 (listValue (countSuperlative (getProperty (singleton en.meal) (string !type)) (string max) (reverse (string meal)) (getProperty (singleton en.recipe) (string !type))))
recipe of at least two cuisine	 (listValue (countComparative (getProperty (singleton en.recipe) (string !type)) (string cuisine) (string >=) (number 2)))
what recipe requires the least ingredients	 (listValue (countSuperlative (getProperty (singleton en.ingredient) (string !type)) (string min) (reverse (string requires)) (getProperty (singleton en.recipe) (string !type))))
what is the cuisine of rice pudding	 (listValue (getProperty en.recipe.rice_pudding (string cuisine)))
recipes with just two ingredients	 (listValue (countComparative (getProperty (singleton en.recipe) (string !type)) (string requires) (string =) (number 2) (getProperty (singleton en.ingredient) (string !type))))
name an ingredient required by two different recipes	 (listValue (countComparative (getProperty (singleton en.ingredient) (string !type)) (reverse (string requires)) (string =) (number 2) (getProperty (singleton en.recipe) (string !type))))
what recipe is cooked in less time than rice pudding	 (listValue (filter (getProperty (singleton en.recipe) (string !type)) (ensureNumericProperty (string cooking_time)) (string <=) (ensureNumericEntity (getProperty en.recipe.rice_pudding (string cooking_time)))))
show recipes with milk as an ingredient and is posted in 2004	 (listValue (filter (filter (getProperty (singleton en.recipe) (string !type)) (string posting_date) (string =) (date 2004 -1 -1)) (string requires) (string =) en.ingredient.milk))
which recipe belongs to less number of cuisines	 (listValue (countSuperlative (getProperty (singleton en.recipe) (string !type)) (string min) (string cuisine)))
what ingredient is needed for fewer than two recipes	 (listValue (countComparative (getProperty (singleton en.ingredient) (string !type)) (reverse (string requires)) (string <) (number 2) (getProperty (singleton en.recipe) (string !type))))
recipe of number of ingredients	 (listValue (countSuperlative (getProperty (singleton en.recipe) (string !type)) (string max) (string requires) (getProperty (singleton en.ingredient) (string !type))))
what to prefer rice pudding or quiche	 (listValue (concat en.recipe.rice_pudding en.recipe.quiche))
what recipe has the least prep time	 (listValue (superlative (getProperty (singleton en.recipe) (string !type)) (string min) (ensureNumericProperty (string preparation_time))))
a recipe that uses two or more ingredients	 (listValue (countComparative (getProperty (singleton en.recipe) (string !type)) (string requires) (string >=) (number 2) (getProperty (singleton en.ingredient) (string !type))))
meal with more than two recipes	 (listValue (countComparative (getProperty (singleton en.meal) (string !type)) (reverse (string meal)) (string >) (number 2) (getProperty (singleton en.recipe) (string !type))))
find recipe that needs the maximum number of food items	 (listValue (countSuperlative (getProperty (singleton en.recipe) (string !type)) (string max) (string requires) (getProperty (singleton en.ingredient) (string !type))))
find recipes posted in 2004	 (listValue (filter (filter (getProperty (singleton en.recipe) (string !type)) (string posting_date) (string =) (date 2004 -1 -1)) (string posting_date) (string =) (date 2004 -1 -1)))
what recipes are prepared in less time tan rice pudding	 (listValue (filter (getProperty (singleton en.recipe) (string !type)) (ensureNumericProperty (string preparation_time)) (string <) (ensureNumericEntity (getProperty en.recipe.rice_pudding (string preparation_time)))))
what time can be prepped in the same time as rice pudding	 (listValue (filter (getProperty (singleton en.recipe) (string !type)) (string preparation_time) (string =) (getProperty en.recipe.rice_pudding (string preparation_time))))
show me recipes with the most preparation time	 (listValue (superlative (getProperty (singleton en.recipe) (string !type)) (string max) (ensureNumericProperty (string preparation_time))))
what meals have recipes that use milk	 (listValue (filter (getProperty (singleton en.meal) (string !type)) (reverse (string meal)) (string =) (filter (getProperty (singleton en.recipe) (string !type)) (string requires) (string =) en.ingredient.milk)))
what meal can you find at least two recipes for	 (listValue (countComparative (getProperty (singleton en.meal) (string !type)) (reverse (string meal)) (string >=) (number 2) (getProperty (singleton en.recipe) (string !type))))
show me recipes for lunch posted in 2004	 (listValue (filter (filter (getProperty (singleton en.recipe) (string !type)) (string meal) (string =) en.meal.lunch) (string posting_date) (string =) (date 2004 -1 -1)))
show recipes whose posting date is not 2004	 (listValue (filter (getProperty (singleton en.recipe) (string !type)) (string posting_date) (string !=) (date 2004 -1 -1)))
find recipes posted before 2004	 (listValue (filter (getProperty (singleton en.recipe) (string !type)) (ensureNumericProperty (string posting_date)) (string <) (ensureNumericEntity (date 2004 -1 -1))))
show me recipes that have the fewest ingredients	 (listValue (countSuperlative (getProperty (singleton en.recipe) (string !type)) (string min) (string requires) (getProperty (singleton en.ingredient) (string !type))))
what recipe takes at least as long to prepare as rice pudding	 (listValue (filter (getProperty (singleton en.recipe) (string !type)) (ensureNumericProperty (string preparation_time)) (string >=) (ensureNumericEntity (getProperty en.recipe.rice_pudding (string preparation_time)))))
show me milkfree recipes	 (listValue (filter (getProperty (singleton en.recipe) (string !type)) (string requires) (string !=) en.ingredient.milk))
show me recipes that have the same or longer preparation time as rice pudding	 (listValue (filter (getProperty (singleton en.recipe) (string !type)) (ensureNumericProperty (string preparation_time)) (string >=) (ensureNumericEntity (getProperty en.recipe.rice_pudding (string cooking_time)))))
what is a meal with the most number of recipes	 (listValue (countSuperlative (getProperty (singleton en.meal) (string !type)) (string max) (reverse (string meal)) (getProperty (singleton en.recipe) (string !type))))
what recipe is a recipe for lunch	 (listValue (filter (getProperty (singleton en.meal) (string !type)) (reverse (string meal)) (string =) (filter (getProperty (singleton en.recipe) (string !type)) (string meal) (string =) en.meal.lunch)))
recipes total preparation time	 (listValue (aggregate (string sum) (getProperty (getProperty (singleton en.recipe) (string !type)) (string preparation_time))))
show me recipes for the most meals	 (listValue (countSuperlative (getProperty (singleton en.recipe) (string !type)) (string max) (string meal) (getProperty (singleton en.meal) (string !type))))
recipes that requires the same or more time to prepare as rice pudding	 (listValue (filter (getProperty (singleton en.recipe) (string !type)) (ensureNumericProperty (string preparation_time)) (string >=) (ensureNumericEntity (getProperty en.recipe.rice_pudding (string cooking_time)))))
what ingredient is required in two or more recipes	 (listValue (countComparative (getProperty (singleton en.ingredient) (string !type)) (reverse (string requires)) (string >=) (number 2) (getProperty (singleton en.recipe) (string !type))))
what is the average prep time for the recipe	 (listValue (aggregate (string avg) (getProperty (getProperty (singleton en.recipe) (string !type)) (string preparation_time))))
what recipe was posted during or before 2004	 (listValue (filter (getProperty (singleton en.recipe) (string !type)) (ensureNumericProperty (string posting_date)) (string <=) (ensureNumericEntity (date 2004 -1 -1))))
show me recipes not for lunch	 (listValue (filter (getProperty (singleton en.recipe) (string !type)) (string meal) (string !=) en.meal.lunch))
which recipes were posted before rice pudding	 (listValue (filter (getProperty (singleton en.recipe) (string !type)) (ensureNumericProperty (string posting_date)) (string <) (ensureNumericEntity (getProperty en.recipe.rice_pudding (string posting_date)))))
show me recipes with posting dates from 2004 or later	 (listValue (filter (getProperty (singleton en.recipe) (string !type)) (ensureNumericProperty (string posting_date)) (string >=) (ensureNumericEntity (concat (date 2004 -1 -1) (date 2010 -1 -1)))))
what recipe calls for two ingredients	 (listValue (countComparative (getProperty (singleton en.recipe) (string !type)) (string requires) (string =) (number 2) (getProperty (singleton en.ingredient) (string !type))))
show me recipes that call for more than two ingredients	 (listValue (countComparative (getProperty (singleton en.recipe) (string !type)) (string requires) (string >) (number 2) (getProperty (singleton en.ingredient) (string !type))))
what recipe is for no more than two meals	 (listValue (countComparative (getProperty (singleton en.recipe) (string !type)) (string meal) (string <=) (number 2) (getProperty (singleton en.meal) (string !type))))
which recipe has a larger cooking time than the preparation time needed for rice pudding	 (listValue (filter (getProperty (singleton en.recipe) (string !type)) (ensureNumericProperty (string cooking_time)) (string >) (ensureNumericEntity (getProperty en.recipe.rice_pudding (string preparation_time)))))
show recipes that requires lesser preparation than rice pudding	 (listValue (filter (getProperty (singleton en.recipe) (string !type)) (ensureNumericProperty (string preparation_time)) (string <) (ensureNumericEntity (getProperty en.recipe.rice_pudding (string preparation_time)))))
what recipe does not need milk	 (listValue (filter (getProperty (singleton en.recipe) (string !type)) (string requires) (string !=) en.ingredient.milk))
what recipe needs least ingredients	 (listValue (countSuperlative (getProperty (singleton en.recipe) (string !type)) (string min) (string requires) (getProperty (singleton en.ingredient) (string !type))))
what is recipe for a meal	 (listValue (countComparative (getProperty (singleton en.recipe) (string !type)) (string meal) (string <) (number 2) (getProperty (singleton en.meal) (string !type))))
what recipes preparation time is greater than that of rice pudding	 (listValue (filter (getProperty (singleton en.recipe) (string !type)) (ensureNumericProperty (string preparation_time)) (string >) (ensureNumericEntity (getProperty en.recipe.rice_pudding (string preparation_time)))))
tell recipes with milk for lunch	 (listValue (filter (filter (getProperty (singleton en.recipe) (string !type)) (string meal) (string =) en.meal.lunch) (string requires) (string =) en.ingredient.milk))
name the recipe that is prepared for lunch	 (listValue (filter (filter (getProperty (singleton en.recipe) (string !type)) (string meal) (string =) en.meal.lunch) (string meal) (string =) en.meal.lunch))
show me the recipe that has the most number of requirements	 (listValue (countSuperlative (getProperty (singleton en.recipe) (string !type)) (string max) (string requires) (getProperty (singleton en.ingredient) (string !type))))
show me recipes for rice pudding or quiche	 (listValue (concat en.recipe.rice_pudding en.recipe.quiche))
what recipe can be used for at least two meals	 (listValue (countComparative (getProperty (singleton en.recipe) (string !type)) (string meal) (string >=) (number 2) (getProperty (singleton en.meal) (string !type))))
show me recipes posted in 2004 requiring milk	 (listValue (filter (filter (getProperty (singleton en.recipe) (string !type)) (string posting_date) (string =) (date 2004 -1 -1)) (string requires) (string =) en.ingredient.milk))
what ingredient is called for by a recipe posted in 2004	 (listValue (filter (getProperty (singleton en.ingredient) (string !type)) (reverse (string requires)) (string =) (filter (getProperty (singleton en.recipe) (string !type)) (string posting_date) (string =) (date 2004 -1 -1))))
how many total meals are there	 (listValue (call .size (getProperty (singleton en.meal) (string !type))))
what recipe has no fewer than two cuisines	 (listValue (countComparative (getProperty (singleton en.recipe) (string !type)) (string cuisine) (string >=) (number 2)))
which recipe requires the least cooking time	 (listValue (superlative (getProperty (singleton en.recipe) (string !type)) (string min) (ensureNumericProperty (string cooking_time))))
what recipes preparation time is the same as rice pudding	 (listValue (filter (getProperty (singleton en.recipe) (string !type)) (string preparation_time) (string =) (getProperty en.recipe.rice_pudding (string preparation_time))))
which recipes take longer to cook than to prepare rice pudding	 (listValue (filter (getProperty (singleton en.recipe) (string !type)) (ensureNumericProperty (string cooking_time)) (string >) (ensureNumericEntity (getProperty en.recipe.rice_pudding (string preparation_time)))))
what recipe takes equal or more time to cook than rice pudding	 (listValue (filter (getProperty (singleton en.recipe) (string !type)) (ensureNumericProperty (string cooking_time)) (string >=) (ensureNumericEntity (getProperty en.recipe.rice_pudding (string cooking_time)))))
show me recipes that need at least three ingrediants	 (listValue (countComparative (getProperty (singleton en.recipe) (string !type)) (string requires) (string >) (number 2) (getProperty (singleton en.ingredient) (string !type))))
recipes that require less or same time than the time taken to prepare rice pudding	 (listValue (filter (getProperty (singleton en.recipe) (string !type)) (ensureNumericProperty (string preparation_time)) (string <=) (ensureNumericEntity (getProperty en.recipe.rice_pudding (string preparation_time)))))
show me recipes that follows one or two cuisines	 (listValue (countComparative (getProperty (singleton en.recipe) (string !type)) (string cuisine) (string <=) (number 2)))
show me recipes that require lesser cooking time than rice pudding	 (listValue (filter (getProperty (singleton en.recipe) (string !type)) (ensureNumericProperty (string cooking_time)) (string <) (ensureNumericEntity (getProperty en.recipe.rice_pudding (string preparation_time)))))
show me recipes posted before any posting for rice pudding	 (listValue (filter (getProperty (singleton en.recipe) (string !type)) (ensureNumericProperty (string posting_date)) (string <) (ensureNumericEntity (getProperty en.recipe.rice_pudding (string posting_date)))))
what recipes posting date is at most 2004 or 2010	 (listValue (filter (getProperty (singleton en.recipe) (string !type)) (ensureNumericProperty (string posting_date)) (string <=) (ensureNumericEntity (concat (date 2004 -1 -1) (date 2010 -1 -1)))))
what is the posting date for rice pudding	 (listValue (getProperty en.recipe.rice_pudding (string posting_date)))
what recipes posting date is greater than that of rice pudding	 (listValue (filter (getProperty (singleton en.recipe) (string !type)) (ensureNumericProperty (string posting_date)) (string >) (ensureNumericEntity (getProperty en.recipe.rice_pudding (string posting_date)))))
show me recipes with the cuisine least represented	 (listValue (countSuperlative (getProperty (singleton en.recipe) (string !type)) (string min) (string cuisine)))
what is the cuisine of rice pudding	 (listValue (getProperty en.recipe.rice_pudding (string cuisine)))
what recipe doesnt require milk	 (listValue (filter (getProperty (singleton en.recipe) (string !type)) (string requires) (string !=) en.ingredient.milk))
what recipe takes longer to cook than rice pudding takes to prep	 (listValue (filter (getProperty (singleton en.recipe) (string !type)) (ensureNumericProperty (string cooking_time)) (string >) (ensureNumericEntity (getProperty en.recipe.rice_pudding (string preparation_time)))))
find a lunch recipe from 2004	 (listValue (filter (filter (getProperty (singleton en.recipe) (string !type)) (string posting_date) (string =) (date 2004 -1 -1)) (string meal) (string =) en.meal.lunch))
what is the average preparation time across all recipes	 (listValue (aggregate (string avg) (getProperty (getProperty (singleton en.recipe) (string !type)) (string preparation_time))))
what meal is the recipe rice pudding for	 (listValue (filter (getProperty (singleton en.recipe) (string !type)) (string meal) (string =) (filter (getProperty (singleton en.meal) (string !type)) (reverse (string meal)) (string =) en.recipe.rice_pudding)))
show me recipes posted during 2004 and 2010	 (listValue (filter (getProperty (singleton en.recipe) (string !type)) (string posting_date) (string =) (concat (date 2004 -1 -1) (date 2010 -1 -1))))
which recipe needs less than two food items for its preparation	 (listValue (countComparative (getProperty (singleton en.recipe) (string !type)) (string requires) (string <) (number 2) (getProperty (singleton en.ingredient) (string !type))))
which meal has two recipes designated for it	 (listValue (countComparative (getProperty (singleton en.meal) (string !type)) (reverse (string meal)) (string =) (number 2) (getProperty (singleton en.recipe) (string !type))))
meal than rice pudding is not taken	 (listValue (filter (getProperty (singleton en.meal) (string !type)) (reverse (string meal)) (string !=) en.recipe.rice_pudding))
show me recipes that require longer time to cook than rice pudding	 (listValue (filter (getProperty (singleton en.recipe) (string !type)) (ensureNumericProperty (string preparation_time)) (string >) (ensureNumericEntity (getProperty en.recipe.rice_pudding (string cooking_time)))))
what recipe has the smallest preparation time	 (listValue (superlative (getProperty (singleton en.recipe) (string !type)) (string min) (ensureNumericProperty (string preparation_time))))
what is the cooking time of rice pudding	 (listValue (getProperty en.recipe.rice_pudding (string cooking_time)))
name an ingredient required in more than two recipes	 (listValue (countComparative (getProperty (singleton en.ingredient) (string !type)) (reverse (string requires)) (string >) (number 2) (getProperty (singleton en.recipe) (string !type))))
what ingredients are used least in recipes	 (listValue (countSuperlative (getProperty (singleton en.ingredient) (string !type)) (string min) (reverse (string requires)) (getProperty (singleton en.recipe) (string !type))))
what ingredients are used by at least two recipes	 (listValue (countComparative (getProperty (singleton en.ingredient) (string !type)) (reverse (string requires)) (string >=) (number 2) (getProperty (singleton en.recipe) (string !type))))
recipes cooking time	 (listValue (aggregate (string sum) (getProperty (getProperty (singleton en.recipe) (string !type)) (string cooking_time))))
what recipe falls under two cuisines	 (listValue (countComparative (getProperty (singleton en.recipe) (string !type)) (string cuisine) (string =) (number 2)))
what recipes have the same cooking time as rice pudding	 (listValue (filter (getProperty (singleton en.recipe) (string !type)) (string cooking_time) (string =) (getProperty en.recipe.rice_pudding (string cooking_time))))
show me recipes that cannot be taken for lunch	 (listValue (filter (getProperty (singleton en.recipe) (string !type)) (string meal) (string !=) en.meal.lunch))
which recipe has a posting date smaller than 2004 or 2010	 (listValue (filter (getProperty (singleton en.recipe) (string !type)) (ensureNumericProperty (string posting_date)) (string <) (ensureNumericEntity (concat (date 2004 -1 -1) (date 2010 -1 -1)))))
meal than has rice pudding or quiche	 (listValue (filter (getProperty (singleton en.meal) (string !type)) (reverse (string meal)) (string =) (concat en.recipe.rice_pudding en.recipe.quiche)))
which recipes are for lunch or dinner	 (listValue (filter (getProperty (singleton en.recipe) (string !type)) (string meal) (string =) (concat en.meal.lunch en.meal.dinner)))
show me recipes with cooking times greater than cooking time of rice pudding	 (listValue (filter (getProperty (singleton en.recipe) (string !type)) (ensureNumericProperty (string cooking_time)) (string >) (ensureNumericEntity (getProperty en.recipe.rice_pudding (string cooking_time)))))
show me recipes for rice pudding meals	 (listValue (filter (getProperty (singleton en.recipe) (string !type)) (string meal) (string =) (filter (getProperty (singleton en.meal) (string !type)) (reverse (string meal)) (string =) en.recipe.rice_pudding)))
what ingredient is not required to make rice pudding	 (listValue (filter (getProperty (singleton en.ingredient) (string !type)) (reverse (string requires)) (string !=) en.recipe.rice_pudding))
show me recipes requiring two or fewer ingredients	 (listValue (countComparative (getProperty (singleton en.recipe) (string !type)) (string requires) (string <=) (number 2) (getProperty (singleton en.ingredient) (string !type))))
show me recipes with posting date before 2010	 (listValue (filter (getProperty (singleton en.recipe) (string !type)) (ensureNumericProperty (string posting_date)) (string <) (ensureNumericEntity (concat (date 2004 -1 -1) (date 2010 -1 -1)))))
show me the average cooking time for all recipes	 (listValue (aggregate (string avg) (getProperty (getProperty (singleton en.recipe) (string !type)) (string cooking_time))))
show recipes that require at the most time as rice pudding preparation	 (listValue (filter (getProperty (singleton en.recipe) (string !type)) (ensureNumericProperty (string cooking_time)) (string <=) (ensureNumericEntity (getProperty en.recipe.rice_pudding (string preparation_time)))))
what recipe is fastest cooked	 (listValue (superlative (getProperty (singleton en.recipe) (string !type)) (string min) (ensureNumericProperty (string cooking_time))))
how many ingredients are needed	 (listValue (call .size (getProperty (singleton en.ingredient) (string !type))))
what recipe has the same cooking time as rice pudding	 (listValue (filter (getProperty (singleton en.recipe) (string !type)) (string cooking_time) (string =) (getProperty en.recipe.rice_pudding (string cooking_time))))
for which meal is rice pudding had	 (listValue (filter (getProperty (singleton en.meal) (string !type)) (reverse (string meal)) (string =) en.recipe.rice_pudding))
which ingredient is needed by many recipes	 (listValue (countSuperlative (getProperty (singleton en.ingredient) (string !type)) (string max) (reverse (string requires)) (getProperty (singleton en.recipe) (string !type))))
what recipe has a cooking time lower than that of rice pudding	 (listValue (filter (getProperty (singleton en.recipe) (string !type)) (ensureNumericProperty (string cooking_time)) (string <) (ensureNumericEntity (getProperty en.recipe.rice_pudding (string cooking_time)))))
which recipes posted in 2004 require milk	 (listValue (filter (filter (getProperty (singleton en.recipe) (string !type)) (string requires) (string =) en.ingredient.milk) (string posting_date) (string =) (date 2004 -1 -1)))
what is a recipe with a prep time less than the cooking time of rice pudding	 (listValue (filter (getProperty (singleton en.recipe) (string !type)) (ensureNumericProperty (string preparation_time)) (string <) (ensureNumericEntity (getProperty en.recipe.rice_pudding (string cooking_time)))))
show recipes that at most have two cuisine	 (listValue (countComparative (getProperty (singleton en.recipe) (string !type)) (string cuisine) (string <=) (number 2)))
show me recipes with the least cooking time	 (listValue (superlative (getProperty (singleton en.recipe) (string !type)) (string min) (ensureNumericProperty (string cooking_time))))
ingredients in rice pudding	 (listValue (filter (filter (getProperty (singleton en.ingredient) (string !type)) (reverse (string requires)) (string =) en.recipe.rice_pudding) (reverse (string requires)) (string =) en.recipe.rice_pudding))
what is the cooking time for rice pudding	 (listValue (getProperty en.recipe.rice_pudding (string cooking_time)))
show me recipes posted at the same date as rice pudding	 (listValue (filter (getProperty (singleton en.recipe) (string !type)) (ensureNumericProperty (string posting_date)) (string <=) (ensureNumericEntity (getProperty en.recipe.rice_pudding (string posting_date)))))
a recipe for rice pudding	 (listValue (getProperty en.recipe.rice_pudding (string cuisine)))
for what meal is rice pudding used for	 (listValue (filter (getProperty (singleton en.meal) (string !type)) (reverse (string meal)) (string =) en.recipe.rice_pudding))
recipes without milk	 (listValue (filter (getProperty (singleton en.recipe) (string !type)) (string requires) (string !=) en.ingredient.milk))
name ingredients that is required in three or more recipes	 (listValue (countComparative (getProperty (singleton en.ingredient) (string !type)) (reverse (string requires)) (string >) (number 2) (getProperty (singleton en.recipe) (string !type))))
what recipes posting date is in 2004 or 2010	 (listValue (filter (getProperty (singleton en.recipe) (string !type)) (string posting_date) (string =) (concat (date 2004 -1 -1) (date 2010 -1 -1))))
which recipes need two ingredients	 (listValue (countComparative (getProperty (singleton en.recipe) (string !type)) (string requires) (string =) (number 2) (getProperty (singleton en.ingredient) (string !type))))
show me recipes posted after 2004 or after 2010	 (listValue (filter (getProperty (singleton en.recipe) (string !type)) (ensureNumericProperty (string posting_date)) (string >) (ensureNumericEntity (concat (date 2004 -1 -1) (date 2010 -1 -1)))))
what recipe is not lunch	 (listValue (filter (getProperty (singleton en.recipe) (string !type)) (string meal) (string !=) en.meal.lunch))
how long does it take to make rice pudding	 (listValue (getProperty en.recipe.rice_pudding (string cooking_time)))
show me recipe that require longer time to cook than rice pudding	 (listValue (filter (getProperty (singleton en.recipe) (string !type)) (ensureNumericProperty (string cooking_time)) (string >) (ensureNumericEntity (getProperty en.recipe.rice_pudding (string cooking_time)))))
what recipe requires the lowest cooking time	 (listValue (superlative (getProperty (singleton en.recipe) (string !type)) (string min) (ensureNumericProperty (string cooking_time))))
recipe having more than two cuisine	 (listValue (countComparative (getProperty (singleton en.recipe) (string !type)) (string cuisine) (string >) (number 2)))
name the recipe used for lunch prepared with milk	 (listValue (filter (filter (getProperty (singleton en.recipe) (string !type)) (string meal) (string =) en.meal.lunch) (string requires) (string =) en.ingredient.milk))
show recipes with the maximum number of cuisines	 (listValue (countSuperlative (getProperty (singleton en.recipe) (string !type)) (string max) (string cuisine)))
what recipes require at leas two ingredients	 (listValue (countComparative (getProperty (singleton en.recipe) (string !type)) (string requires) (string >=) (number 2) (getProperty (singleton en.ingredient) (string !type))))
which is the most used ingredient in recipes	 (listValue (countSuperlative (getProperty (singleton en.ingredient) (string !type)) (string max) (reverse (string requires)) (getProperty (singleton en.recipe) (string !type))))
what is the posting date of rice pudding	 (listValue (getProperty en.recipe.rice_pudding (string posting_date)))
what recipe has the fewest number of cuisine	 (listValue (countSuperlative (getProperty (singleton en.recipe) (string !type)) (string min) (string cuisine)))
for which meal is that recipe with post date in 2004	 (listValue (filter (getProperty (singleton en.meal) (string !type)) (reverse (string meal)) (string =) (filter (getProperty (singleton en.recipe) (string !type)) (string posting_date) (string =) (date 2004 -1 -1))))
which recipe takes less time to prepare than rice pudding	 (listValue (filter (getProperty (singleton en.recipe) (string !type)) (ensureNumericProperty (string cooking_time)) (string <) (ensureNumericEntity (getProperty en.recipe.rice_pudding (string cooking_time)))))
an ingredient required by at least two recipes	 (listValue (countComparative (getProperty (singleton en.ingredient) (string !type)) (reverse (string requires)) (string >=) (number 2) (getProperty (singleton en.recipe) (string !type))))
show recipes that does not have milk as one of its ingredients	 (listValue (filter (getProperty (singleton en.recipe) (string !type)) (string requires) (string !=) en.ingredient.milk))
how much time it takes to prepare recipe	 (listValue (aggregate (string sum) (getProperty (getProperty (singleton en.recipe) (string !type)) (string preparation_time))))
what recipe takes the longest to prepare	 (listValue (superlative (getProperty (singleton en.recipe) (string !type)) (string max) (ensureNumericProperty (string preparation_time))))
how long does the recipe take to prepare	 (listValue (aggregate (string sum) (getProperty (getProperty (singleton en.recipe) (string !type)) (string preparation_time))))
show me the oldest recipe	 (listValue (superlative (getProperty (singleton en.recipe) (string !type)) (string min) (ensureNumericProperty (string posting_date))))
find meal recipes for lunch	 (listValue (filter (getProperty (singleton en.meal) (string !type)) (reverse (string meal)) (string =) (filter (getProperty (singleton en.recipe) (string !type)) (string meal) (string =) en.meal.lunch)))
what recipe cooks for less time than rice pudding takes to prep	 (listValue (filter (getProperty (singleton en.recipe) (string !type)) (ensureNumericProperty (string cooking_time)) (string <) (ensureNumericEntity (getProperty en.recipe.rice_pudding (string preparation_time)))))
what meal has the most number of recipes	 (listValue (countSuperlative (getProperty (singleton en.meal) (string !type)) (string max) (reverse (string meal)) (getProperty (singleton en.recipe) (string !type))))
what recipe takes the shortest time to cook	 (listValue (superlative (getProperty (singleton en.recipe) (string !type)) (string min) (ensureNumericProperty (string cooking_time))))
show me recipes with a preparation time greater than rice pudding	 (listValue (filter (getProperty (singleton en.recipe) (string !type)) (ensureNumericProperty (string preparation_time)) (string >) (ensureNumericEntity (getProperty en.recipe.rice_pudding (string preparation_time)))))
what day was rice pudding posted	 (listValue (getProperty en.recipe.rice_pudding (string posting_date)))
what meal has two or more recipes	 (listValue (countComparative (getProperty (singleton en.meal) (string !type)) (reverse (string meal)) (string >=) (number 2) (getProperty (singleton en.recipe) (string !type))))
what ingredients are needed for lunch recipes	 (listValue (filter (getProperty (singleton en.ingredient) (string !type)) (reverse (string requires)) (string =) (filter (getProperty (singleton en.recipe) (string !type)) (string meal) (string =) en.meal.lunch)))
what is the total preparation time of all the recipes	 (listValue (aggregate (string sum) (getProperty (getProperty (singleton en.recipe) (string !type)) (string preparation_time))))
find some lunch recipes	 (listValue (filter (getProperty (singleton en.recipe) (string !type)) (string meal) (string =) en.meal.lunch))
what recipe was posted in 2004	 (listValue (filter (getProperty (singleton en.recipe) (string !type)) (string posting_date) (string =) (date 2004 -1 -1)))
what recipe was posted no later than the rice pudding recipe	 (listValue (filter (getProperty (singleton en.recipe) (string !type)) (ensureNumericProperty (string posting_date)) (string <=) (ensureNumericEntity (getProperty en.recipe.rice_pudding (string posting_date)))))
how many recipes use more than two ingredients	 (listValue (countComparative (getProperty (singleton en.recipe) (string !type)) (string requires) (string >) (number 2) (getProperty (singleton en.ingredient) (string !type))))
which recipe has the shortest preparation time	 (listValue (superlative (getProperty (singleton en.recipe) (string !type)) (string min) (ensureNumericProperty (string preparation_time))))
how many meals are there	 (listValue (call .size (getProperty (singleton en.meal) (string !type))))
recipes posted with or after posting rice pudding	 (listValue (filter (getProperty (singleton en.recipe) (string !type)) (ensureNumericProperty (string posting_date)) (string >=) (ensureNumericEntity (getProperty en.recipe.rice_pudding (string posting_date)))))
what is the most ingredient that this recipe requires	 (listValue (countSuperlative (getProperty (singleton en.ingredient) (string !type)) (string max) (reverse (string requires)) (getProperty (singleton en.recipe) (string !type))))
which recipe has the cooking time of rice pudding	 (listValue (filter (getProperty (singleton en.recipe) (string !type)) (ensureNumericProperty (string cooking_time)) (string <=) (ensureNumericEntity (getProperty en.recipe.rice_pudding (string cooking_time)))))
show me recipes requiring an ingredient from rice pudding	 (listValue (filter (getProperty (singleton en.recipe) (string !type)) (string requires) (string =) (filter (getProperty (singleton en.ingredient) (string !type)) (reverse (string requires)) (string =) en.recipe.rice_pudding)))
what is an ingredient found in no more than two recipes	 (listValue (countComparative (getProperty (singleton en.ingredient) (string !type)) (reverse (string requires)) (string <=) (number 2) (getProperty (singleton en.recipe) (string !type))))
show me recipes with cooking time equal to preparation time for rice pudding	 (listValue (filter (getProperty (singleton en.recipe) (string !type)) (string cooking_time) (string =) (getProperty en.recipe.rice_pudding (string preparation_time))))
what is the total prep time for the recipes	 (listValue (aggregate (string sum) (getProperty (getProperty (singleton en.recipe) (string !type)) (string preparation_time))))
which recipes require the same ingredients as rice pudding	 (listValue (filter (getProperty (singleton en.recipe) (string !type)) (string requires) (string =) (filter (getProperty (singleton en.ingredient) (string !type)) (reverse (string requires)) (string =) en.recipe.rice_pudding)))
what recipes need milk or spinach	 (listValue (concat en.ingredient.milk en.ingredient.spinach))
what meal has fewer than two recipes to make it	 (listValue (countComparative (getProperty (singleton en.meal) (string !type)) (reverse (string meal)) (string <) (number 2) (getProperty (singleton en.recipe) (string !type))))
which recipes require the least amount of ingredients	 (listValue (countSuperlative (getProperty (singleton en.recipe) (string !type)) (string min) (string requires) (getProperty (singleton en.ingredient) (string !type))))
which recipe requires less cooking time than rice pudding preparation	 (listValue (filter (getProperty (singleton en.recipe) (string !type)) (ensureNumericProperty (string cooking_time)) (string <) (ensureNumericEntity (getProperty en.recipe.rice_pudding (string preparation_time)))))
what recipes posting date is greater than 2004 or 2010	 (listValue (filter (getProperty (singleton en.recipe) (string !type)) (ensureNumericProperty (string posting_date)) (string >) (ensureNumericEntity (concat (date 2004 -1 -1) (date 2010 -1 -1)))))
which recipe needs the longest preparation tome	 (listValue (superlative (getProperty (singleton en.recipe) (string !type)) (string max) (ensureNumericProperty (string preparation_time))))
what recipe has the greatest cooking time	 (listValue (superlative (getProperty (singleton en.recipe) (string !type)) (string max) (ensureNumericProperty (string cooking_time))))
which recipe belongs to the cuisine of rice pudding	 (listValue (filter (getProperty (singleton en.recipe) (string !type)) (string cuisine) (string =) (getProperty en.recipe.rice_pudding (string cuisine))))
show me recipes without milk	 (listValue (filter (getProperty (singleton en.recipe) (string !type)) (string requires) (string !=) en.ingredient.milk))
what recipe has a cook time equal to the prep time of rice pudding	 (listValue (filter (getProperty (singleton en.recipe) (string !type)) (string cooking_time) (string =) (getProperty en.recipe.rice_pudding (string preparation_time))))
find the recipes of multiple cuisine	 (listValue (countComparative (getProperty (singleton en.recipe) (string !type)) (string cuisine) (string >=) (number 2)))
show me ingredients required by more than two recipes	 (listValue (countComparative (getProperty (singleton en.ingredient) (string !type)) (reverse (string requires)) (string >) (number 2) (getProperty (singleton en.recipe) (string !type))))
what recipes need three or more ingredients	 (listValue (countComparative (getProperty (singleton en.recipe) (string !type)) (string requires) (string >) (number 2) (getProperty (singleton en.ingredient) (string !type))))
which recipes were posted after 2004	 (listValue (filter (getProperty (singleton en.recipe) (string !type)) (ensureNumericProperty (string posting_date)) (string >) (ensureNumericEntity (date 2004 -1 -1))))
recipes for less than three meals	 (listValue (countComparative (getProperty (singleton en.recipe) (string !type)) (string meal) (string <=) (number 2) (getProperty (singleton en.meal) (string !type))))
show recipes posted on dates between 2004 and 2010	 (listValue (filter (getProperty (singleton en.recipe) (string !type)) (ensureNumericProperty (string posting_date)) (string <) (ensureNumericEntity (concat (date 2004 -1 -1) (date 2010 -1 -1)))))
show me ingredients required by lunch recipes	 (listValue (filter (getProperty (singleton en.ingredient) (string !type)) (reverse (string requires)) (string =) (filter (getProperty (singleton en.recipe) (string !type)) (string meal) (string =) en.meal.lunch)))
show recipes whose cooking time is same as that of rice pudding	 (listValue (filter (getProperty (singleton en.recipe) (string !type)) (string cooking_time) (string =) (getProperty en.recipe.rice_pudding (string preparation_time))))
what are the recipes posted in2004 or 2010	 (listValue (filter (getProperty (singleton en.recipe) (string !type)) (ensureNumericProperty (string posting_date)) (string >=) (ensureNumericEntity (concat (date 2004 -1 -1) (date 2010 -1 -1)))))
which meal has the least recipes dedicated to it	 (listValue (countSuperlative (getProperty (singleton en.meal) (string !type)) (string min) (reverse (string meal)) (getProperty (singleton en.recipe) (string !type))))
what recipe is most recent	 (listValue (superlative (getProperty (singleton en.recipe) (string !type)) (string max) (ensureNumericProperty (string posting_date))))
recipes with more preparation time than rice pudding	 (listValue (filter (getProperty (singleton en.recipe) (string !type)) (ensureNumericProperty (string preparation_time)) (string >) (ensureNumericEntity (getProperty en.recipe.rice_pudding (string preparation_time)))))
what recipe was posted in 2004 and needs milk	 (listValue (filter (filter (getProperty (singleton en.recipe) (string !type)) (string posting_date) (string =) (date 2004 -1 -1)) (string requires) (string =) en.ingredient.milk))
find recipes posted in 2005	 (listValue (filter (getProperty (singleton en.recipe) (string !type)) (string posting_date) (string =) (date 2004 -1 -1)))
show me recipes posted the same day as rice pudding or before	 (listValue (filter (getProperty (singleton en.recipe) (string !type)) (ensureNumericProperty (string posting_date)) (string <=) (ensureNumericEntity (getProperty en.recipe.rice_pudding (string posting_date)))))
which recipes require milk	 (listValue (filter (getProperty (singleton en.ingredient) (string !type)) (reverse (string requires)) (string =) (filter (getProperty (singleton en.recipe) (string !type)) (string requires) (string =) en.ingredient.milk)))
what is an ingredient used in more than two recipes	 (listValue (countComparative (getProperty (singleton en.ingredient) (string !type)) (reverse (string requires)) (string >) (number 2) (getProperty (singleton en.recipe) (string !type))))
which recipe was posted in 2004 or 2010	 (listValue (filter (getProperty (singleton en.recipe) (string !type)) (ensureNumericProperty (string posting_date)) (string <=) (ensureNumericEntity (concat (date 2004 -1 -1) (date 2010 -1 -1)))))
which recipe requires at least two ingredients	 (listValue (countComparative (getProperty (singleton en.recipe) (string !type)) (string requires) (string >=) (number 2) (getProperty (singleton en.ingredient) (string !type))))
what is an ingredient not found in rice pudding	 (listValue (filter (getProperty (singleton en.ingredient) (string !type)) (reverse (string requires)) (string !=) en.recipe.rice_pudding))
what is the average cooking time of recipe	 (listValue (aggregate (string avg) (getProperty (getProperty (singleton en.recipe) (string !type)) (string cooking_time))))
show me recipes posted in or after 2004 or in or after 2010	 (listValue (filter (getProperty (singleton en.recipe) (string !type)) (ensureNumericProperty (string posting_date)) (string >=) (ensureNumericEntity (concat (date 2004 -1 -1) (date 2010 -1 -1)))))
show me recipes for at least two meals	 (listValue (countComparative (getProperty (singleton en.recipe) (string !type)) (string meal) (string >=) (number 2) (getProperty (singleton en.meal) (string !type))))
what ingredients do recipes posted in 2004 call for	 (listValue (filter (getProperty (singleton en.ingredient) (string !type)) (reverse (string requires)) (string =) (filter (getProperty (singleton en.recipe) (string !type)) (string posting_date) (string =) (date 2004 -1 -1))))
name the ingredient not required in rice pudding	 (listValue (filter (getProperty (singleton en.ingredient) (string !type)) (reverse (string requires)) (string !=) en.recipe.rice_pudding))
what is a recipe from the same cuisine as rice pudding	 (listValue (filter (getProperty (singleton en.recipe) (string !type)) (string cuisine) (string =) (getProperty en.recipe.rice_pudding (string cuisine))))
which recipes were posted when rice pudding was posted	 (listValue (filter (getProperty (singleton en.recipe) (string !type)) (ensureNumericProperty (string posting_date)) (string >=) (ensureNumericEntity (getProperty en.recipe.rice_pudding (string posting_date)))))
what recipes posted in 2004 require milk	 (listValue (filter (filter (getProperty (singleton en.recipe) (string !type)) (string requires) (string =) en.ingredient.milk) (string posting_date) (string =) (date 2004 -1 -1)))
what meal is a recipe that requires milk for	 (listValue (filter (getProperty (singleton en.meal) (string !type)) (reverse (string meal)) (string =) (filter (getProperty (singleton en.recipe) (string !type)) (string requires) (string =) en.ingredient.milk)))
show me recipes that take as long to prepare as rice pudding	 (listValue (filter (getProperty (singleton en.recipe) (string !type)) (ensureNumericProperty (string preparation_time)) (string <=) (ensureNumericEntity (getProperty en.recipe.rice_pudding (string preparation_time)))))
what recipe was posted the same day as rice pudding	 (listValue (filter (getProperty (singleton en.recipe) (string !type)) (string posting_date) (string =) (getProperty en.recipe.rice_pudding (string posting_date))))
which recipes are for two meals at most	 (listValue (countComparative (getProperty (singleton en.recipe) (string !type)) (string meal) (string <=) (number 2) (getProperty (singleton en.meal) (string !type))))
show me recipes posted after 2004	 (listValue (filter (getProperty (singleton en.recipe) (string !type)) (ensureNumericProperty (string posting_date)) (string >=) (ensureNumericEntity (concat (date 2004 -1 -1) (date 2010 -1 -1)))))
what recipes posting date is greater than 2004	 (listValue (filter (getProperty (singleton en.recipe) (string !type)) (ensureNumericProperty (string posting_date)) (string >) (ensureNumericEntity (date 2004 -1 -1))))
find the recipes for same cuisine as rice pudding	 (listValue (filter (getProperty (singleton en.recipe) (string !type)) (string cuisine) (string =) (getProperty en.recipe.rice_pudding (string cuisine))))
what kind of cuisine is rice pudding	 (listValue (getProperty en.recipe.rice_pudding (string cuisine)))
what ingredient is used only in a single recipe	 (listValue (countComparative (getProperty (singleton en.ingredient) (string !type)) (reverse (string requires)) (string <) (number 2) (getProperty (singleton en.recipe) (string !type))))
what recipe was posted after 2004	 (listValue (filter (getProperty (singleton en.recipe) (string !type)) (ensureNumericProperty (string posting_date)) (string >) (ensureNumericEntity (date 2004 -1 -1))))
recipes posted till rice pudding is posted	 (listValue (filter (getProperty (singleton en.recipe) (string !type)) (ensureNumericProperty (string posting_date)) (string <=) (ensureNumericEntity (getProperty en.recipe.rice_pudding (string posting_date)))))
show me recipes posted 2004 and earlier	 (listValue (filter (getProperty (singleton en.recipe) (string !type)) (ensureNumericProperty (string posting_date)) (string <=) (ensureNumericEntity (date 2004 -1 -1))))
find a meal recipe posted in 2004	 (listValue (filter (getProperty (singleton en.meal) (string !type)) (reverse (string meal)) (string =) (filter (getProperty (singleton en.recipe) (string !type)) (string posting_date) (string =) (date 2004 -1 -1))))
show me recipes whose preparation time is a most the cooking time of rice pudding	 (listValue (filter (getProperty (singleton en.recipe) (string !type)) (ensureNumericProperty (string preparation_time)) (string <=) (ensureNumericEntity (getProperty en.recipe.rice_pudding (string cooking_time)))))
show me meals with the least recipes	 (listValue (countSuperlative (getProperty (singleton en.meal) (string !type)) (string min) (reverse (string meal)) (getProperty (singleton en.recipe) (string !type))))
how many ingredients are used	 (listValue (call .size (getProperty (singleton en.ingredient) (string !type))))
show me recipes that have a preparation time less than the cooking time of rice pudding	 (listValue (filter (getProperty (singleton en.recipe) (string !type)) (ensureNumericProperty (string preparation_time)) (string <) (ensureNumericEntity (getProperty en.recipe.rice_pudding (string cooking_time)))))
what recipe was posted before rice pudding	 (listValue (filter (getProperty (singleton en.recipe) (string !type)) (ensureNumericProperty (string posting_date)) (string <) (ensureNumericEntity (getProperty en.recipe.rice_pudding (string posting_date)))))
when was rice pudding posted	 (listValue (getProperty en.recipe.rice_pudding (string posting_date)))
recipes for least number of meals	 (listValue (countSuperlative (getProperty (singleton en.recipe) (string !type)) (string min) (string meal) (getProperty (singleton en.meal) (string !type))))
show me recipes for fewer than two meals	 (listValue (countComparative (getProperty (singleton en.recipe) (string !type)) (string meal) (string <) (number 2) (getProperty (singleton en.meal) (string !type))))
what is a recipe whose cooking time is the same as rice pudding	 (listValue (filter (getProperty (singleton en.recipe) (string !type)) (string cooking_time) (string =) (getProperty en.recipe.rice_pudding (string cooking_time))))
show recipes posted in 2004 and has milk as one of its ingredients	 (listValue (filter (filter (getProperty (singleton en.recipe) (string !type)) (string requires) (string =) en.ingredient.milk) (string posting_date) (string =) (date 2004 -1 -1)))
what recipe has the shortest cooking time	 (listValue (superlative (getProperty (singleton en.recipe) (string !type)) (string min) (ensureNumericProperty (string cooking_time))))
meal with milk recipe	 (listValue (filter (getProperty (singleton en.meal) (string !type)) (reverse (string meal)) (string =) (filter (getProperty (singleton en.recipe) (string !type)) (string requires) (string =) en.ingredient.milk)))
which recipe can be prepared at the earliest	 (listValue (superlative (getProperty (singleton en.recipe) (string !type)) (string min) (ensureNumericProperty (string preparation_time))))
a lunch recipe posted in 2004	 (listValue (filter (filter (getProperty (singleton en.recipe) (string !type)) (string meal) (string =) en.meal.lunch) (string posting_date) (string =) (date 2004 -1 -1)))
what lunch recipes contain milk	 (listValue (filter (filter (getProperty (singleton en.recipe) (string !type)) (string requires) (string =) en.ingredient.milk) (string meal) (string =) en.meal.lunch))
show me meals including rice pudding	 (listValue (filter (getProperty (singleton en.meal) (string !type)) (reverse (string meal)) (string =) en.recipe.rice_pudding))
which recipe is prepared using the same amount of time as that of rice pudding	 (listValue (filter (getProperty (singleton en.recipe) (string !type)) (ensureNumericProperty (string preparation_time)) (string >=) (ensureNumericEntity (getProperty en.recipe.rice_pudding (string preparation_time)))))
list recipes that require milk	 (listValue (filter (getProperty (singleton en.ingredient) (string !type)) (reverse (string requires)) (string =) (filter (getProperty (singleton en.recipe) (string !type)) (string requires) (string =) en.ingredient.milk)))
what recipe was posted no later than 2004 or 2010	 (listValue (filter (getProperty (singleton en.recipe) (string !type)) (ensureNumericProperty (string posting_date)) (string <=) (ensureNumericEntity (concat (date 2004 -1 -1) (date 2010 -1 -1)))))
recipe for three or more meals	 (listValue (countComparative (getProperty (singleton en.recipe) (string !type)) (string meal) (string >=) (number 2) (getProperty (singleton en.meal) (string !type))))
what ingredient is in over two recipes	 (listValue (countComparative (getProperty (singleton en.ingredient) (string !type)) (reverse (string requires)) (string >) (number 2) (getProperty (singleton en.recipe) (string !type))))
which recipes take as long as prepare rice pudding	 (listValue (filter (getProperty (singleton en.recipe) (string !type)) (ensureNumericProperty (string cooking_time)) (string <=) (ensureNumericEntity (getProperty en.recipe.rice_pudding (string preparation_time)))))
find two meal recipes	 (listValue (countComparative (getProperty (singleton en.meal) (string !type)) (reverse (string meal)) (string <=) (number 2) (getProperty (singleton en.recipe) (string !type))))
what recipe has two or less types of cuisine	 (listValue (countComparative (getProperty (singleton en.recipe) (string !type)) (string cuisine) (string <=) (number 2)))
recipe requires less than three ingredients	 (listValue (countComparative (getProperty (singleton en.recipe) (string !type)) (string requires) (string <=) (number 2) (getProperty (singleton en.ingredient) (string !type))))
what recipe takes longer to prep than rice pudding	 (listValue (filter (getProperty (singleton en.recipe) (string !type)) (ensureNumericProperty (string preparation_time)) (string >) (ensureNumericEntity (getProperty en.recipe.rice_pudding (string preparation_time)))))
show me recipes that were posted later than 2004	 (listValue (filter (getProperty (singleton en.meal) (string !type)) (reverse (string meal)) (string =) (filter (getProperty (singleton en.recipe) (string !type)) (string posting_date) (string =) (date 2004 -1 -1))))
show me recipes with a preparation time equal to the cooking time of rice pudding	 (listValue (filter (getProperty (singleton en.recipe) (string !type)) (string preparation_time) (string =) (getProperty en.recipe.rice_pudding (string cooking_time))))
find recipes posted later than 2004 or 2010	 (listValue (filter (getProperty (singleton en.recipe) (string !type)) (ensureNumericProperty (string posting_date)) (string >) (ensureNumericEntity (concat (date 2004 -1 -1) (date 2010 -1 -1)))))
show me recipes that have the same preparation time as rice pudding	 (listValue (filter (getProperty (singleton en.recipe) (string !type)) (string preparation_time) (string =) (getProperty en.recipe.rice_pudding (string preparation_time))))
show me recipe requiring milk posted in 2004	 (listValue (filter (filter (getProperty (singleton en.recipe) (string !type)) (string requires) (string =) en.ingredient.milk) (string posting_date) (string =) (date 2004 -1 -1)))
recipes posted after 2003	 (listValue (filter (getProperty (singleton en.recipe) (string !type)) (ensureNumericProperty (string posting_date)) (string >=) (ensureNumericEntity (concat (date 2004 -1 -1) (date 2010 -1 -1)))))
quiche or rice pudding	 (listValue (concat en.recipe.rice_pudding en.recipe.quiche))
show me recipes that follows two or more cuisines	 (listValue (countComparative (getProperty (singleton en.recipe) (string !type)) (string cuisine) (string >=) (number 2)))
show me recipes that whose preparation time is shorter than rice puddings cooking time	 (listValue (filter (getProperty (singleton en.recipe) (string !type)) (ensureNumericProperty (string preparation_time)) (string <) (ensureNumericEntity (getProperty en.recipe.rice_pudding (string cooking_time)))))
what recipes have the same or longer preparation time as rice pudding	 (listValue (filter (getProperty (singleton en.recipe) (string !type)) (ensureNumericProperty (string preparation_time)) (string >=) (ensureNumericEntity (getProperty en.recipe.rice_pudding (string preparation_time)))))
what other ingredients do recipes that use milk require	 (listValue (filter (getProperty (singleton en.ingredient) (string !type)) (reverse (string requires)) (string =) (filter (getProperty (singleton en.recipe) (string !type)) (string requires) (string =) en.ingredient.milk)))
what recipe is used in the greatest number of cuisines	 (listValue (countSuperlative (getProperty (singleton en.recipe) (string !type)) (string max) (string cuisine)))
which recipe takes the longest to prepare	 (listValue (superlative (getProperty (singleton en.recipe) (string !type)) (string max) (ensureNumericProperty (string preparation_time))))
show me recipes for lunch	 (listValue (filter (filter (getProperty (singleton en.recipe) (string !type)) (string meal) (string =) en.meal.lunch) (string meal) (string =) en.meal.lunch))
show me meals with more than two recipes	 (listValue (countComparative (getProperty (singleton en.meal) (string !type)) (reverse (string meal)) (string >) (number 2) (getProperty (singleton en.recipe) (string !type))))
which recipes have at most two cuisines	 (listValue (countComparative (getProperty (singleton en.recipe) (string !type)) (string cuisine) (string <=) (number 2)))
show me recipes with two ingredients	 (listValue (countComparative (getProperty (singleton en.recipe) (string !type)) (string requires) (string =) (number 2) (getProperty (singleton en.ingredient) (string !type))))
a recipe that posted after 2004 or 2010	 (listValue (filter (getProperty (singleton en.recipe) (string !type)) (ensureNumericProperty (string posting_date)) (string >) (ensureNumericEntity (concat (date 2004 -1 -1) (date 2010 -1 -1)))))
show me ingredients required for two recipes at most	 (listValue (countComparative (getProperty (singleton en.ingredient) (string !type)) (reverse (string requires)) (string <=) (number 2) (getProperty (singleton en.recipe) (string !type))))
what is a meal with a recipe posted in 2004	 (listValue (filter (getProperty (singleton en.meal) (string !type)) (reverse (string meal)) (string =) (filter (getProperty (singleton en.recipe) (string !type)) (string posting_date) (string =) (date 2004 -1 -1))))
recipes that require lesser time to prepare than rice pudding	 (listValue (filter (getProperty (singleton en.recipe) (string !type)) (ensureNumericProperty (string preparation_time)) (string <) (ensureNumericEntity (getProperty en.recipe.rice_pudding (string cooking_time)))))
find me all recipes that require milk	 (listValue (filter (getProperty (singleton en.recipe) (string !type)) (string requires) (string =) en.ingredient.milk))
which recipes were posted in 2004 for lunch	 (listValue (filter (filter (getProperty (singleton en.recipe) (string !type)) (string meal) (string =) en.meal.lunch) (string posting_date) (string =) (date 2004 -1 -1)))
what is a recipe that takes at least as long to make as rice pudding	 (listValue (filter (getProperty (singleton en.recipe) (string !type)) (ensureNumericProperty (string preparation_time)) (string >=) (ensureNumericEntity (getProperty en.recipe.rice_pudding (string preparation_time)))))
which recipe was posted the latest	 (listValue (superlative (getProperty (singleton en.recipe) (string !type)) (string max) (ensureNumericProperty (string posting_date))))
what is a recipe which was posted no later than 2004	 (listValue (filter (getProperty (singleton en.recipe) (string !type)) (ensureNumericProperty (string posting_date)) (string <=) (ensureNumericEntity (date 2004 -1 -1))))
how many total ingredients are used in all the recipes	 (listValue (call .size (getProperty (singleton en.ingredient) (string !type))))
which recipe takes the least amount of time to prepare	 (listValue (superlative (getProperty (singleton en.recipe) (string !type)) (string min) (ensureNumericProperty (string preparation_time))))
what recipe calls for either milk or spinach	 (listValue (filter (getProperty (singleton en.recipe) (string !type)) (string requires) (string =) (concat en.ingredient.milk en.ingredient.spinach)))
what ingredient is called for by the most recipes	 (listValue (countSuperlative (getProperty (singleton en.ingredient) (string !type)) (string max) (reverse (string requires)) (getProperty (singleton en.recipe) (string !type))))
what recipe is cooked faster than rice pudding	 (listValue (filter (getProperty (singleton en.recipe) (string !type)) (ensureNumericProperty (string cooking_time)) (string <) (ensureNumericEntity (getProperty en.recipe.rice_pudding (string cooking_time)))))
show me meals with the most recipes	 (listValue (countSuperlative (getProperty (singleton en.meal) (string !type)) (string max) (reverse (string meal)) (getProperty (singleton en.recipe) (string !type))))
show me meals with at least two recipes	 (listValue (countComparative (getProperty (singleton en.meal) (string !type)) (reverse (string meal)) (string >=) (number 2) (getProperty (singleton en.recipe) (string !type))))
find recipes that can be used for more than two meals	 (listValue (countComparative (getProperty (singleton en.recipe) (string !type)) (string meal) (string >) (number 2) (getProperty (singleton en.meal) (string !type))))
recipes posted before 2004	 (listValue (filter (getProperty (singleton en.recipe) (string !type)) (ensureNumericProperty (string posting_date)) (string <) (ensureNumericEntity (date 2004 -1 -1))))
show recipes for lunch or dinner	 (listValue (filter (getProperty (singleton en.recipe) (string !type)) (string meal) (string =) (concat en.meal.lunch en.meal.dinner)))
what is an ingredient found in a lunch recipe	 (listValue (filter (getProperty (singleton en.ingredient) (string !type)) (reverse (string requires)) (string =) (filter (getProperty (singleton en.recipe) (string !type)) (string meal) (string =) en.meal.lunch)))
which recipes were posted up to 2004	 (listValue (filter (getProperty (singleton en.recipe) (string !type)) (ensureNumericProperty (string posting_date)) (string <=) (ensureNumericEntity (date 2004 -1 -1))))
what recipes cooking time is at lowest that of rice pudding	 (listValue (filter (getProperty (singleton en.recipe) (string !type)) (ensureNumericProperty (string cooking_time)) (string >=) (ensureNumericEntity (getProperty en.recipe.rice_pudding (string cooking_time)))))
what recipe was posted before 2010	 (listValue (filter (getProperty (singleton en.recipe) (string !type)) (ensureNumericProperty (string posting_date)) (string <) (ensureNumericEntity (concat (date 2004 -1 -1) (date 2010 -1 -1)))))
what recipe requires highest number of ingredients	 (listValue (countSuperlative (getProperty (singleton en.recipe) (string !type)) (string max) (string requires) (getProperty (singleton en.ingredient) (string !type))))
this receipe requires more than two ingredient	 (listValue (countComparative (getProperty (singleton en.recipe) (string !type)) (string requires) (string >) (number 2) (getProperty (singleton en.ingredient) (string !type))))
what recipes require one or two ingredients	 (listValue (countComparative (getProperty (singleton en.recipe) (string !type)) (string requires) (string <=) (number 2) (getProperty (singleton en.ingredient) (string !type))))
which recipes require at most two ingredients	 (listValue (countComparative (getProperty (singleton en.recipe) (string !type)) (string requires) (string <=) (number 2) (getProperty (singleton en.ingredient) (string !type))))
recipe whose posting date is at least rice puddings posting date	 (listValue (filter (getProperty (singleton en.recipe) (string !type)) (ensureNumericProperty (string posting_date)) (string >=) (ensureNumericEntity (getProperty en.recipe.rice_pudding (string posting_date)))))
what recipe can make fewer than two types of cuisine	 (listValue (countComparative (getProperty (singleton en.recipe) (string !type)) (string cuisine) (string <) (number 2)))
which recipes were posted at the same time as rice pudding	 (listValue (filter (getProperty (singleton en.recipe) (string !type)) (string posting_date) (string =) (getProperty en.recipe.rice_pudding (string posting_date))))
what ingredients are required in two recipes	 (listValue (countComparative (getProperty (singleton en.ingredient) (string !type)) (reverse (string requires)) (string =) (number 2) (getProperty (singleton en.recipe) (string !type))))
which recipes have less than two cuisines	 (listValue (countComparative (getProperty (singleton en.recipe) (string !type)) (string cuisine) (string <) (number 2)))
what recipes cooking time is lower than the preparation time of rice pudding	 (listValue (filter (getProperty (singleton en.recipe) (string !type)) (ensureNumericProperty (string cooking_time)) (string <) (ensureNumericEntity (getProperty en.recipe.rice_pudding (string preparation_time)))))
which recipe can be used for two or more meals	 (listValue (countComparative (getProperty (singleton en.recipe) (string !type)) (string meal) (string >=) (number 2) (getProperty (singleton en.meal) (string !type))))
preparation time of recipe not more than that of rice pudding	 (listValue (filter (getProperty (singleton en.recipe) (string !type)) (ensureNumericProperty (string preparation_time)) (string <=) (ensureNumericEntity (getProperty en.recipe.rice_pudding (string cooking_time)))))
what recipes take more time to prepare than rice pudding	 (listValue (filter (getProperty (singleton en.recipe) (string !type)) (ensureNumericProperty (string cooking_time)) (string >) (ensureNumericEntity (getProperty en.recipe.rice_pudding (string preparation_time)))))
which recipes have a preparation time as long as the cooking time of rice pudding	 (listValue (filter (getProperty (singleton en.recipe) (string !type)) (string preparation_time) (string =) (getProperty en.recipe.rice_pudding (string cooking_time))))
what is a recipe with the most ingredients	 (listValue (countSuperlative (getProperty (singleton en.recipe) (string !type)) (string max) (string cuisine)))
what ingredients are used in rice pudding or quiche	 (listValue (filter (getProperty (singleton en.ingredient) (string !type)) (reverse (string requires)) (string =) (concat en.recipe.rice_pudding en.recipe.quiche)))
show me ingredients required by recipes posted in 2004	 (listValue (filter (getProperty (singleton en.ingredient) (string !type)) (reverse (string requires)) (string =) (filter (getProperty (singleton en.recipe) (string !type)) (string posting_date) (string =) (date 2004 -1 -1))))
what recipe takes the longest to cook	 (listValue (superlative (getProperty (singleton en.recipe) (string !type)) (string max) (ensureNumericProperty (string cooking_time))))
what recipe do you cook for less time than rice pudding	 (listValue (filter (getProperty (singleton en.recipe) (string !type)) (ensureNumericProperty (string cooking_time)) (string <) (ensureNumericEntity (getProperty en.recipe.rice_pudding (string cooking_time)))))
what recipe takes equal or less time to cook than rice pudding takes to prep	 (listValue (filter (getProperty (singleton en.recipe) (string !type)) (ensureNumericProperty (string cooking_time)) (string <=) (ensureNumericEntity (getProperty en.recipe.rice_pudding (string preparation_time)))))
show ingredients for lunch recipes	 (listValue (filter (getProperty (singleton en.ingredient) (string !type)) (reverse (string requires)) (string =) (filter (getProperty (singleton en.recipe) (string !type)) (string meal) (string =) en.meal.lunch)))
how many meals does this make	 (listValue (call .size (getProperty (singleton en.meal) (string !type))))
show me recipes with cooking time less than the preparation time for rice pudding	 (listValue (filter (getProperty (singleton en.recipe) (string !type)) (ensureNumericProperty (string cooking_time)) (string <) (ensureNumericEntity (getProperty en.recipe.rice_pudding (string preparation_time)))))
show me recipes that have shorter cooking times than rice pudding	 (listValue (filter (getProperty (singleton en.recipe) (string !type)) (ensureNumericProperty (string cooking_time)) (string <) (ensureNumericEntity (getProperty en.recipe.rice_pudding (string cooking_time)))))
what recipes posting date is in 2004 and what ingredients does it require	 (listValue (filter (getProperty (singleton en.ingredient) (string !type)) (reverse (string requires)) (string =) (filter (getProperty (singleton en.recipe) (string !type)) (string posting_date) (string =) (date 2004 -1 -1))))
what recipes require milk and are for lunch	 (listValue (filter (filter (getProperty (singleton en.recipe) (string !type)) (string meal) (string =) en.meal.lunch) (string requires) (string =) en.ingredient.milk))
what recipe is prepared in preparation time of rice pudding or earlier	 (listValue (filter (getProperty (singleton en.recipe) (string !type)) (ensureNumericProperty (string preparation_time)) (string >=) (ensureNumericEntity (getProperty en.recipe.rice_pudding (string preparation_time)))))
show me meals for one	 (listValue (countSuperlative (getProperty (singleton en.meal) (string !type)) (string min) (reverse (string meal)) (getProperty (singleton en.recipe) (string !type))))
show me recipes posted in or before 2004 or in or before 2010	 (listValue (filter (getProperty (singleton en.recipe) (string !type)) (ensureNumericProperty (string posting_date)) (string <=) (ensureNumericEntity (concat (date 2004 -1 -1) (date 2010 -1 -1)))))
what meal is rice pudding or quiche in	 (listValue (filter (getProperty (singleton en.meal) (string !type)) (reverse (string meal)) (string =) (concat en.recipe.rice_pudding en.recipe.quiche)))
show me recipes that fall under the same cuisine as rice pudding	 (listValue (filter (getProperty (singleton en.recipe) (string !type)) (string cuisine) (string =) (getProperty en.recipe.rice_pudding (string cuisine))))
is the recipe for lunch or dinner	 (listValue (concat en.meal.lunch en.meal.dinner))
recipes for two meal	 (listValue (countComparative (getProperty (singleton en.recipe) (string !type)) (string meal) (string =) (number 2) (getProperty (singleton en.meal) (string !type))))
for which meal is rice pudding or quiche had	 (listValue (filter (getProperty (singleton en.meal) (string !type)) (reverse (string meal)) (string =) (concat en.recipe.rice_pudding en.recipe.quiche)))
show recipes with one cuisine	 (listValue (countSuperlative (getProperty (singleton en.recipe) (string !type)) (string min) (string cuisine)))
what recipe posted in 2004 calls for milk	 (listValue (filter (filter (getProperty (singleton en.recipe) (string !type)) (string requires) (string =) en.ingredient.milk) (string posting_date) (string =) (date 2004 -1 -1)))
list the ingredients of rice pudding	 (listValue (filter (getProperty (singleton en.ingredient) (string !type)) (reverse (string requires)) (string =) en.recipe.rice_pudding))
which recipe was posted first	 (listValue (superlative (getProperty (singleton en.recipe) (string !type)) (string min) (ensureNumericProperty (string posting_date))))
what recipe is for two meals	 (listValue (countComparative (getProperty (singleton en.recipe) (string !type)) (string meal) (string >=) (number 2) (getProperty (singleton en.meal) (string !type))))
what recipes posting date is no greater than that of rice pudding	 (listValue (filter (getProperty (singleton en.recipe) (string !type)) (ensureNumericProperty (string posting_date)) (string <=) (ensureNumericEntity (getProperty en.recipe.rice_pudding (string posting_date)))))
show me recipes with a cooking time equal to the preparation time for rice pudding	 (listValue (filter (getProperty (singleton en.recipe) (string !type)) (string cooking_time) (string =) (getProperty en.recipe.rice_pudding (string preparation_time))))
what recipe requires more prep time than rice pudding	 (listValue (filter (getProperty (singleton en.recipe) (string !type)) (ensureNumericProperty (string preparation_time)) (string >) (ensureNumericEntity (getProperty en.recipe.rice_pudding (string preparation_time)))))
which recipes take less or as long to prepare as rice pudding	 (listValue (filter (getProperty (singleton en.recipe) (string !type)) (ensureNumericProperty (string preparation_time)) (string <=) (ensureNumericEntity (getProperty en.recipe.rice_pudding (string preparation_time)))))
what recipe is for less than two people	 (listValue (countComparative (getProperty (singleton en.recipe) (string !type)) (string meal) (string <) (number 2) (getProperty (singleton en.meal) (string !type))))
show recipes that requires at most the preparation time of rice pudding	 (listValue (filter (getProperty (singleton en.recipe) (string !type)) (ensureNumericProperty (string preparation_time)) (string <=) (ensureNumericEntity (getProperty en.recipe.rice_pudding (string cooking_time)))))
recipe with posting date 2004	 (listValue (filter (getProperty (singleton en.recipe) (string !type)) (string posting_date) (string =) (date 2004 -1 -1)))
a recipe with milk posted in 2004	 (listValue (filter (filter (getProperty (singleton en.recipe) (string !type)) (string posting_date) (string =) (date 2004 -1 -1)) (string requires) (string =) en.ingredient.milk))
which recipes are not for lunch	 (listValue (filter (getProperty (singleton en.recipe) (string !type)) (string meal) (string !=) en.meal.lunch))
how many total recipes are there	 (listValue (call .size (getProperty (singleton en.recipe) (string !type))))
what recipe has the most types of cuisine	 (listValue (countSuperlative (getProperty (singleton en.recipe) (string !type)) (string max) (string cuisine)))
what recipes take the same amount of time or less to cook as rice pudding	 (listValue (filter (getProperty (singleton en.recipe) (string !type)) (ensureNumericProperty (string cooking_time)) (string <=) (ensureNumericEntity (getProperty en.recipe.rice_pudding (string cooking_time)))))
which meal has least number of recipes	 (listValue (countSuperlative (getProperty (singleton en.meal) (string !type)) (string min) (reverse (string meal)) (getProperty (singleton en.recipe) (string !type))))
which lunch recipe requires milk for its preparation	 (listValue (filter (filter (getProperty (singleton en.recipe) (string !type)) (string meal) (string =) en.meal.lunch) (string requires) (string =) en.ingredient.milk))
what recipe is not for a lunch meal	 (listValue (filter (getProperty (singleton en.recipe) (string !type)) (string meal) (string =) en.meal.lunch))
find recipes that need two ingredients	 (listValue (countComparative (getProperty (singleton en.recipe) (string !type)) (string requires) (string <=) (number 2) (getProperty (singleton en.ingredient) (string !type))))
which recipe has the shortest ingredient list	 (listValue (countSuperlative (getProperty (singleton en.recipe) (string !type)) (string min) (string requires) (getProperty (singleton en.ingredient) (string !type))))
show me recipes that need milk and were posted in 2004	 (listValue (filter (filter (getProperty (singleton en.recipe) (string !type)) (string requires) (string =) en.ingredient.milk) (string posting_date) (string =) (date 2004 -1 -1)))
what is a cuisine of rice pudding	 (listValue (getProperty en.recipe.rice_pudding (string cuisine)))
show me recipes with a cooking time greater or equal to the preparation time for rice pudding	 (listValue (filter (getProperty (singleton en.recipe) (string !type)) (ensureNumericProperty (string cooking_time)) (string >=) (ensureNumericEntity (getProperty en.recipe.rice_pudding (string preparation_time)))))
show me a meal that has more than two recipes	 (listValue (countComparative (getProperty (singleton en.meal) (string !type)) (reverse (string meal)) (string >) (number 2) (getProperty (singleton en.recipe) (string !type))))
name lunch recipes	 (listValue (filter (filter (getProperty (singleton en.recipe) (string !type)) (string meal) (string =) en.meal.lunch) (string meal) (string =) en.meal.lunch))
show me recipes posted before rice pudding	 (listValue (filter (getProperty (singleton en.recipe) (string !type)) (ensureNumericProperty (string posting_date)) (string <) (ensureNumericEntity (getProperty en.recipe.rice_pudding (string posting_date)))))
which recipe is found in only one cuisine	 (listValue (countComparative (getProperty (singleton en.recipe) (string !type)) (string cuisine) (string <) (number 2)))
show me recipes with fewer than two cuisines	 (listValue (countComparative (getProperty (singleton en.recipe) (string !type)) (string cuisine) (string <) (number 2)))
ingredients not required to prepare rice pudding	 (listValue (filter (getProperty (singleton en.ingredient) (string !type)) (reverse (string requires)) (string !=) en.recipe.rice_pudding))
what is a recipe from no more than two different cuisines	 (listValue (countComparative (getProperty (singleton en.recipe) (string !type)) (string cuisine) (string <=) (number 2)))
what recipe is for two or fewer meals	 (listValue (countComparative (getProperty (singleton en.recipe) (string !type)) (string meal) (string <=) (number 2) (getProperty (singleton en.meal) (string !type))))
recipes posted before rice pudding	 (listValue (filter (getProperty (singleton en.recipe) (string !type)) (ensureNumericProperty (string posting_date)) (string <) (ensureNumericEntity (getProperty en.recipe.rice_pudding (string posting_date)))))
what recipe can make the most meals	 (listValue (countSuperlative (getProperty (singleton en.recipe) (string !type)) (string max) (string meal) (getProperty (singleton en.meal) (string !type))))
what recipe can you prep in the same or more time as it takes to cook rice pudding	 (listValue (filter (getProperty (singleton en.recipe) (string !type)) (ensureNumericProperty (string preparation_time)) (string >=) (ensureNumericEntity (getProperty en.recipe.rice_pudding (string cooking_time)))))
list the lunch recipes contains milk	 (listValue (filter (filter (getProperty (singleton en.recipe) (string !type)) (string meal) (string =) en.meal.lunch) (string requires) (string =) en.ingredient.milk))
what recipe can you prep in the same or longer amount of time as rice pudding	 (listValue (filter (getProperty (singleton en.recipe) (string !type)) (ensureNumericProperty (string preparation_time)) (string >=) (ensureNumericEntity (getProperty en.recipe.rice_pudding (string preparation_time)))))
what recipes are for the same meal as rice pudding	 (listValue (filter (getProperty (singleton en.recipe) (string !type)) (string meal) (string =) (filter (getProperty (singleton en.meal) (string !type)) (reverse (string meal)) (string =) en.recipe.rice_pudding)))
recipes posted after 2004	 (listValue (filter (getProperty (singleton en.recipe) (string !type)) (ensureNumericProperty (string posting_date)) (string >) (ensureNumericEntity (date 2004 -1 -1))))
which meal has the least number of recipes	 (listValue (countSuperlative (getProperty (singleton en.meal) (string !type)) (string min) (reverse (string meal)) (getProperty (singleton en.recipe) (string !type))))
show me meal with less than two recipe	 (listValue (countComparative (getProperty (singleton en.meal) (string !type)) (reverse (string meal)) (string <) (number 2) (getProperty (singleton en.recipe) (string !type))))
find a lunch recipe that was posted in 2004	 (listValue (filter (filter (getProperty (singleton en.recipe) (string !type)) (string meal) (string =) en.meal.lunch) (string posting_date) (string =) (date 2004 -1 -1)))
show recipes posted on the same date as rice pudding	 (listValue (filter (getProperty (singleton en.recipe) (string !type)) (string posting_date) (string =) (getProperty en.recipe.rice_pudding (string posting_date))))
what recipe posted in 2004 can make a lunch meal	 (listValue (filter (filter (getProperty (singleton en.recipe) (string !type)) (string meal) (string =) en.meal.lunch) (string posting_date) (string =) (date 2004 -1 -1)))
show me recipes posted on the same day as rice pudding	 (listValue (filter (getProperty (singleton en.recipe) (string !type)) (string posting_date) (string =) (getProperty en.recipe.rice_pudding (string posting_date))))
which recipes require two or more ingredients	 (listValue (countComparative (getProperty (singleton en.ingredient) (string !type)) (reverse (string requires)) (string >=) (number 2) (getProperty (singleton en.recipe) (string !type))))
show recipes that has milk as its ingredient	 (listValue (filter (filter (getProperty (singleton en.recipe) (string !type)) (string requires) (string =) en.ingredient.milk) (string requires) (string =) en.ingredient.milk))
which recipes were posted before 2004	 (listValue (filter (getProperty (singleton en.recipe) (string !type)) (ensureNumericProperty (string posting_date)) (string <) (ensureNumericEntity (date 2004 -1 -1))))
what recipe can be prepped in equal or less time than rice pudding	 (listValue (filter (getProperty (singleton en.recipe) (string !type)) (ensureNumericProperty (string preparation_time)) (string <=) (ensureNumericEntity (getProperty en.recipe.rice_pudding (string preparation_time)))))
what is the number of ingredients for that recipe	 (listValue (call .size (getProperty (singleton en.ingredient) (string !type))))
what is a meal with rice pudding as a dish	 (listValue (filter (getProperty (singleton en.meal) (string !type)) (reverse (string meal)) (string =) en.recipe.rice_pudding))
what recipes require milk	 (listValue (filter (filter (getProperty (singleton en.recipe) (string !type)) (string requires) (string =) en.ingredient.milk) (string requires) (string =) en.ingredient.milk))
what is an ingredient required by the most recipes	 (listValue (countSuperlative (getProperty (singleton en.ingredient) (string !type)) (string max) (reverse (string requires)) (getProperty (singleton en.recipe) (string !type))))
which recipe needs longer preparation time than that of rice pudding	 (listValue (filter (getProperty (singleton en.recipe) (string !type)) (ensureNumericProperty (string preparation_time)) (string >) (ensureNumericEntity (getProperty en.recipe.rice_pudding (string cooking_time)))))
average cooking time	 (listValue (aggregate (string avg) (getProperty (getProperty (singleton en.recipe) (string !type)) (string cooking_time))))
what recipes have the same or less preparation time as rice pudding	 (listValue (filter (getProperty (singleton en.recipe) (string !type)) (ensureNumericProperty (string preparation_time)) (string <=) (ensureNumericEntity (getProperty en.recipe.rice_pudding (string preparation_time)))))
show me recipes posted the same day as rice pudding or after	 (listValue (filter (getProperty (singleton en.recipe) (string !type)) (ensureNumericProperty (string posting_date)) (string >=) (ensureNumericEntity (getProperty en.recipe.rice_pudding (string posting_date)))))
name a recipe with a prep time no longer than the cook time for rice pudding	 (listValue (filter (getProperty (singleton en.recipe) (string !type)) (ensureNumericProperty (string preparation_time)) (string <=) (ensureNumericEntity (getProperty en.recipe.rice_pudding (string cooking_time)))))
when is rice pudding recipe posted	 (listValue (getProperty en.recipe.rice_pudding (string posting_date)))
a recipe which posted before 2004	 (listValue (filter (getProperty (singleton en.recipe) (string !type)) (ensureNumericProperty (string posting_date)) (string <) (ensureNumericEntity (date 2004 -1 -1))))
how long does the recipe take to cook	 (listValue (aggregate (string sum) (getProperty (getProperty (singleton en.recipe) (string !type)) (string cooking_time))))
find recipes that can be prepared sooner than rice pudding	 (listValue (filter (getProperty (singleton en.recipe) (string !type)) (ensureNumericProperty (string preparation_time)) (string <) (ensureNumericEntity (getProperty en.recipe.rice_pudding (string preparation_time)))))
recipes that have cooking time less than cooking time of rice pudding	 (listValue (filter (getProperty (singleton en.recipe) (string !type)) (ensureNumericProperty (string cooking_time)) (string <=) (ensureNumericEntity (getProperty en.recipe.rice_pudding (string cooking_time)))))
what recipe makes the fewest meals	 (listValue (countSuperlative (getProperty (singleton en.recipe) (string !type)) (string min) (string meal) (getProperty (singleton en.meal) (string !type))))
show me recipes that require milk	 (listValue (filter (getProperty (singleton en.recipe) (string !type)) (string requires) (string =) en.ingredient.milk))
what recipes require the same ingredients as rice pudding	 (listValue (filter (getProperty (singleton en.recipe) (string !type)) (string requires) (string =) (filter (getProperty (singleton en.ingredient) (string !type)) (reverse (string requires)) (string =) en.recipe.rice_pudding)))
recipes posted in 2004 and later	 (listValue (filter (getProperty (singleton en.recipe) (string !type)) (ensureNumericProperty (string posting_date)) (string >=) (ensureNumericEntity (date 2004 -1 -1))))
which is the recipe that was posted last	 (listValue (superlative (getProperty (singleton en.recipe) (string !type)) (string max) (ensureNumericProperty (string posting_date))))
what lunch recipes posting date is 2004	 (listValue (filter (filter (getProperty (singleton en.recipe) (string !type)) (string meal) (string =) en.meal.lunch) (string posting_date) (string =) (date 2004 -1 -1)))
what recipes were posted before 2004	 (listValue (filter (getProperty (singleton en.recipe) (string !type)) (ensureNumericProperty (string posting_date)) (string <) (ensureNumericEntity (date 2004 -1 -1))))
what recipes were posted after rice pudding	 (listValue (filter (getProperty (singleton en.recipe) (string !type)) (ensureNumericProperty (string posting_date)) (string >) (ensureNumericEntity (getProperty en.recipe.rice_pudding (string posting_date)))))
show me ingredients required for fewer than two recipes	 (listValue (countComparative (getProperty (singleton en.ingredient) (string !type)) (reverse (string requires)) (string <) (number 2) (getProperty (singleton en.recipe) (string !type))))
which recipe requires two ingredients	 (listValue (countComparative (getProperty (singleton en.recipe) (string !type)) (string requires) (string =) (number 2) (getProperty (singleton en.ingredient) (string !type))))
what is a meal with no more than two recipes	 (listValue (countComparative (getProperty (singleton en.meal) (string !type)) (reverse (string meal)) (string <=) (number 2) (getProperty (singleton en.recipe) (string !type))))
which recipe has the least number of meals	 (listValue (countSuperlative (getProperty (singleton en.recipe) (string !type)) (string min) (string meal) (getProperty (singleton en.meal) (string !type))))
what recipe was posted before 2004	 (listValue (filter (getProperty (singleton en.recipe) (string !type)) (ensureNumericProperty (string posting_date)) (string <) (ensureNumericEntity (date 2004 -1 -1))))
show me recipes posted in or before 2004	 (listValue (filter (getProperty (singleton en.recipe) (string !type)) (ensureNumericProperty (string posting_date)) (string <=) (ensureNumericEntity (date 2004 -1 -1))))
how many ingredients are there	 (listValue (call .size (getProperty (singleton en.ingredient) (string !type))))
recipe in least cuisines	 (listValue (countSuperlative (getProperty (singleton en.recipe) (string !type)) (string min) (string cuisine)))
what are the ingredients of rice pudding or quiche	 (listValue (filter (getProperty (singleton en.ingredient) (string !type)) (reverse (string requires)) (string =) (concat en.recipe.rice_pudding en.recipe.quiche)))
find a recipe that is not suitable for lunch	 (listValue (filter (getProperty (singleton en.recipe) (string !type)) (string meal) (string !=) en.meal.lunch))
which recipe falls under the most kinds of cuisine	 (listValue (countSuperlative (getProperty (singleton en.recipe) (string !type)) (string max) (string cuisine)))
find a recipe for lunch	 (listValue (filter (filter (getProperty (singleton en.recipe) (string !type)) (string meal) (string =) en.meal.lunch) (string meal) (string =) en.meal.lunch))
show me recipes not posted in 2004	 (listValue (filter (getProperty (singleton en.recipe) (string !type)) (string posting_date) (string !=) (date 2004 -1 -1)))
which recipe posted in 2004 needs milk for preparation	 (listValue (filter (filter (getProperty (singleton en.recipe) (string !type)) (string requires) (string =) en.ingredient.milk) (string posting_date) (string =) (date 2004 -1 -1)))
for what meals require less than two recipes	 (listValue (countComparative (getProperty (singleton en.meal) (string !type)) (reverse (string meal)) (string <) (number 2) (getProperty (singleton en.recipe) (string !type))))
show me recipes with cooking times equal to cooking time of rice pudding	 (listValue (filter (getProperty (singleton en.recipe) (string !type)) (string cooking_time) (string =) (getProperty en.recipe.rice_pudding (string cooking_time))))
single ingredient recipe	 (listValue (countComparative (getProperty (singleton en.recipe) (string !type)) (string requires) (string <) (number 2) (getProperty (singleton en.ingredient) (string !type))))
what recipe was posted in either 2004 or 2010	 (listValue (filter (getProperty (singleton en.recipe) (string !type)) (string posting_date) (string =) (concat (date 2004 -1 -1) (date 2010 -1 -1))))
show me recipes requiring the fewest ingredients	 (listValue (countSuperlative (getProperty (singleton en.recipe) (string !type)) (string min) (string requires) (getProperty (singleton en.ingredient) (string !type))))
what recipe has the fewest amount of ingredients	 (listValue (countSuperlative (getProperty (singleton en.recipe) (string !type)) (string min) (string requires) (getProperty (singleton en.ingredient) (string !type))))
show me meals with two recipes	 (listValue (countComparative (getProperty (singleton en.meal) (string !type)) (reverse (string meal)) (string =) (number 2) (getProperty (singleton en.recipe) (string !type))))
which recipe was posted the earliest	 (listValue (superlative (getProperty (singleton en.recipe) (string !type)) (string min) (ensureNumericProperty (string posting_date))))
what recipe is for two	 (listValue (countComparative (getProperty (singleton en.recipe) (string !type)) (string meal) (string <=) (number 2) (getProperty (singleton en.meal) (string !type))))
which ingredient is needed by rice pudding or quiche	 (listValue (filter (getProperty (singleton en.ingredient) (string !type)) (reverse (string requires)) (string =) (concat en.recipe.rice_pudding en.recipe.quiche)))
recipe whose cooking time is not more than rice pudding	 (listValue (filter (getProperty (singleton en.recipe) (string !type)) (ensureNumericProperty (string cooking_time)) (string <=) (ensureNumericEntity (getProperty en.recipe.rice_pudding (string cooking_time)))))
what recipe prepare in less or same time to cook rice pudding	 (listValue (filter (getProperty (singleton en.recipe) (string !type)) (ensureNumericProperty (string preparation_time)) (string >=) (ensureNumericEntity (getProperty en.recipe.rice_pudding (string cooking_time)))))
what ingredients are not in the rice pudding recipe	 (listValue (filter (getProperty (singleton en.ingredient) (string !type)) (reverse (string requires)) (string !=) en.recipe.rice_pudding))
tell me ingredients of rice pudding	 (listValue (filter (filter (getProperty (singleton en.ingredient) (string !type)) (reverse (string requires)) (string =) en.recipe.rice_pudding) (reverse (string requires)) (string =) en.recipe.rice_pudding))
which meal had two recipes or more	 (listValue (countComparative (getProperty (singleton en.meal) (string !type)) (reverse (string meal)) (string >) (number 2) (getProperty (singleton en.recipe) (string !type))))
what recipe is found in two different meals	 (listValue (countComparative (getProperty (singleton en.recipe) (string !type)) (string meal) (string =) (number 2) (getProperty (singleton en.meal) (string !type))))
what ingredients are in rice pudding	 (listValue (filter (filter (getProperty (singleton en.ingredient) (string !type)) (reverse (string requires)) (string =) en.recipe.rice_pudding) (reverse (string requires)) (string =) en.recipe.rice_pudding))
show me recipes that need milk	 (listValue (filter (filter (getProperty (singleton en.recipe) (string !type)) (string requires) (string =) en.ingredient.milk) (string requires) (string =) en.ingredient.milk))
what meal is rice pudding not used for	 (listValue (filter (getProperty (singleton en.meal) (string !type)) (reverse (string meal)) (string !=) en.recipe.rice_pudding))
what recipe takes more time to prepare than rice pudding	 (listValue (filter (getProperty (singleton en.recipe) (string !type)) (ensureNumericProperty (string cooking_time)) (string >) (ensureNumericEntity (getProperty en.recipe.rice_pudding (string preparation_time)))))
what ingredients does quiche or rice pudding require	 (listValue (filter (getProperty (singleton en.ingredient) (string !type)) (reverse (string requires)) (string =) (concat en.recipe.rice_pudding en.recipe.quiche)))
how many total recipes are listed	 (listValue (call .size (getProperty (singleton en.recipe) (string !type))))
what recipe was posted after or on the same day as rice pudding	 (listValue (filter (getProperty (singleton en.recipe) (string !type)) (ensureNumericProperty (string posting_date)) (string >=) (ensureNumericEntity (getProperty en.recipe.rice_pudding (string posting_date)))))
show me recipes that take the same amount of time or more to cook as rice pudding	 (listValue (filter (getProperty (singleton en.recipe) (string !type)) (ensureNumericProperty (string cooking_time)) (string >=) (ensureNumericEntity (getProperty en.recipe.rice_pudding (string cooking_time)))))
which recipes were posted before 2004 or 2010	 (listValue (filter (getProperty (singleton en.recipe) (string !type)) (ensureNumericProperty (string posting_date)) (string <) (ensureNumericEntity (concat (date 2004 -1 -1) (date 2010 -1 -1)))))
find the recipes for lunch	 (listValue (filter (filter (getProperty (singleton en.recipe) (string !type)) (string meal) (string =) en.meal.lunch) (string meal) (string =) en.meal.lunch))
show me recipes that use less than two ingredients	 (listValue (countComparative (getProperty (singleton en.recipe) (string !type)) (string requires) (string <) (number 2) (getProperty (singleton en.ingredient) (string !type))))
show me recipes that require two ingredients	 (listValue (countComparative (getProperty (singleton en.recipe) (string !type)) (string requires) (string =) (number 2) (getProperty (singleton en.ingredient) (string !type))))
what ingredients do lunch recipes need	 (listValue (filter (getProperty (singleton en.ingredient) (string !type)) (reverse (string requires)) (string =) (filter (getProperty (singleton en.recipe) (string !type)) (string meal) (string =) en.meal.lunch)))
show me recipes that involve two or more ingredients	 (listValue (countComparative (getProperty (singleton en.recipe) (string !type)) (string requires) (string >=) (number 2) (getProperty (singleton en.ingredient) (string !type))))
show me recipes requiring milk or spinach	 (listValue (filter (getProperty (singleton en.recipe) (string !type)) (string requires) (string =) (concat en.ingredient.milk en.ingredient.spinach)))
either lunch or dinner	 (listValue (concat en.meal.lunch en.meal.dinner))
which recipe requires milk or spinach	 (listValue (concat en.ingredient.milk en.ingredient.spinach))
how many recipes are there	 (listValue (call .size (getProperty (singleton en.recipe) (string !type))))
what is a meal for which there are fewer than two recipes	 (listValue (countComparative (getProperty (singleton en.meal) (string !type)) (reverse (string meal)) (string <) (number 2) (getProperty (singleton en.recipe) (string !type))))
what recipe cooks in more or the same time as rice pudding takes to prep	 (listValue (filter (getProperty (singleton en.recipe) (string !type)) (ensureNumericProperty (string cooking_time)) (string >=) (ensureNumericEntity (getProperty en.recipe.rice_pudding (string preparation_time)))))
what is a meal that incorporates rice pudding	 (listValue (filter (filter (getProperty (singleton en.meal) (string !type)) (reverse (string meal)) (string =) en.recipe.rice_pudding) (reverse (string meal)) (string =) en.recipe.rice_pudding))
what recipe makes a non lunch meal	 (listValue (filter (getProperty (singleton en.recipe) (string !type)) (string meal) (string !=) en.meal.lunch))
name a recipe which was posted on or later than the posting date of the rice pudding recipe	 (listValue (filter (getProperty (singleton en.recipe) (string !type)) (ensureNumericProperty (string posting_date)) (string >=) (ensureNumericEntity (getProperty en.recipe.rice_pudding (string posting_date)))))
which recipe has the least preparation time	 (listValue (superlative (getProperty (singleton en.recipe) (string !type)) (string min) (ensureNumericProperty (string preparation_time))))
recipe cooked in less time than rice pudding preparation	 (listValue (filter (getProperty (singleton en.recipe) (string !type)) (ensureNumericProperty (string cooking_time)) (string <) (ensureNumericEntity (getProperty en.recipe.rice_pudding (string preparation_time)))))
show me recipes posted in 2004	 (listValue (filter (getProperty (singleton en.recipe) (string !type)) (string posting_date) (string =) (date 2004 -1 -1)))
recipe of cuisine of rice pudding	 (listValue (filter (getProperty (singleton en.recipe) (string !type)) (string cuisine) (string =) (getProperty en.recipe.rice_pudding (string cuisine))))
which meals are recipes posted in 2004 for	 (listValue (filter (getProperty (singleton en.meal) (string !type)) (reverse (string meal)) (string =) (filter (getProperty (singleton en.recipe) (string !type)) (string posting_date) (string =) (date 2004 -1 -1))))
show me recipes designed for two meals	 (listValue (countComparative (getProperty (singleton en.recipe) (string !type)) (string meal) (string =) (number 2) (getProperty (singleton en.meal) (string !type))))
show me recipes that requires the most time to prepare the dish	 (listValue (superlative (getProperty (singleton en.recipe) (string !type)) (string max) (ensureNumericProperty (string preparation_time))))
find recipes for all kinds of meals	 (listValue (countSuperlative (getProperty (singleton en.recipe) (string !type)) (string max) (string meal) (getProperty (singleton en.meal) (string !type))))
show me recipes that take less time to cook than it takes to prepare rice pudding	 (listValue (filter (getProperty (singleton en.recipe) (string !type)) (ensureNumericProperty (string cooking_time)) (string <) (ensureNumericEntity (getProperty en.recipe.rice_pudding (string preparation_time)))))
show me recipes that were not posted in 2004	 (listValue (filter (getProperty (singleton en.recipe) (string !type)) (string posting_date) (string !=) (date 2004 -1 -1)))
which recipes can be used for most number of meals	 (listValue (countSuperlative (getProperty (singleton en.recipe) (string !type)) (string max) (string meal) (getProperty (singleton en.meal) (string !type))))
a recipe for a meal other than lunch	 (listValue (filter (getProperty (singleton en.recipe) (string !type)) (string meal) (string !=) en.meal.lunch))
what recipes preparation time is no more than the preparation time of rice pudding	 (listValue (filter (getProperty (singleton en.recipe) (string !type)) (ensureNumericProperty (string preparation_time)) (string <=) (ensureNumericEntity (getProperty en.recipe.rice_pudding (string preparation_time)))))
show me meals with two or fewer recipes	 (listValue (countComparative (getProperty (singleton en.meal) (string !type)) (reverse (string meal)) (string <=) (number 2) (getProperty (singleton en.recipe) (string !type))))
what is a recipe from fewer than two cuisines	 (listValue (countComparative (getProperty (singleton en.recipe) (string !type)) (string cuisine) (string <) (number 2)))
show me recipes that fall under two cuisines or less	 (listValue (countComparative (getProperty (singleton en.recipe) (string !type)) (string cuisine) (string <=) (number 2)))
which recipes require more than two ingredients	 (listValue (countComparative (getProperty (singleton en.recipe) (string !type)) (string requires) (string >) (number 2) (getProperty (singleton en.ingredient) (string !type))))
recipe with only one ingredient	 (listValue (countComparative (getProperty (singleton en.recipe) (string !type)) (string requires) (string <) (number 2) (getProperty (singleton en.ingredient) (string !type))))
which recipes require milk or spinach	 (listValue (filter (getProperty (singleton en.recipe) (string !type)) (string requires) (string =) (concat en.ingredient.milk en.ingredient.spinach)))
what is the most commonly used ingredient	 (listValue (countSuperlative (getProperty (singleton en.ingredient) (string !type)) (string max) (reverse (string requires)) (getProperty (singleton en.recipe) (string !type))))
what recipes posting date is in 2004	 (listValue (filter (getProperty (singleton en.meal) (string !type)) (reverse (string meal)) (string =) (filter (getProperty (singleton en.recipe) (string !type)) (string posting_date) (string =) (date 2004 -1 -1))))
what recipes cooking time is longer than that of rice pudding	 (listValue (filter (getProperty (singleton en.recipe) (string !type)) (ensureNumericProperty (string cooking_time)) (string >) (ensureNumericEntity (getProperty en.recipe.rice_pudding (string preparation_time)))))
for what meals share two or more recipes	 (listValue (countComparative (getProperty (singleton en.meal) (string !type)) (reverse (string meal)) (string >) (number 2) (getProperty (singleton en.recipe) (string !type))))
what meal has at least two recipes for it	 (listValue (countComparative (getProperty (singleton en.meal) (string !type)) (reverse (string meal)) (string >=) (number 2) (getProperty (singleton en.recipe) (string !type))))
which food item is needed in two recipes or more	 (listValue (countComparative (getProperty (singleton en.ingredient) (string !type)) (reverse (string requires)) (string >) (number 2) (getProperty (singleton en.recipe) (string !type))))
show recipes for the meal as the same for rice pudding	 (listValue (filter (getProperty (singleton en.recipe) (string !type)) (string meal) (string =) (filter (getProperty (singleton en.meal) (string !type)) (reverse (string meal)) (string =) en.recipe.rice_pudding)))
show me recipes with cooking time equal to or greater than cooking time for rice pudding	 (listValue (filter (getProperty (singleton en.recipe) (string !type)) (ensureNumericProperty (string cooking_time)) (string >=) (ensureNumericEntity (getProperty en.recipe.rice_pudding (string cooking_time)))))
what recipe has the latest date posted	 (listValue (superlative (getProperty (singleton en.recipe) (string !type)) (string max) (ensureNumericProperty (string posting_date))))
which recipe needs a minimum of two ingredients	 (listValue (countComparative (getProperty (singleton en.recipe) (string !type)) (string requires) (string >=) (number 2) (getProperty (singleton en.ingredient) (string !type))))
show me recipes that can be used for two meals	 (listValue (countComparative (getProperty (singleton en.recipe) (string !type)) (string meal) (string =) (number 2) (getProperty (singleton en.meal) (string !type))))
what recipe was posted last	 (listValue (superlative (getProperty (singleton en.recipe) (string !type)) (string max) (ensureNumericProperty (string posting_date))))
show me recipes posted after 2004	 (listValue (filter (getProperty (singleton en.recipe) (string !type)) (ensureNumericProperty (string posting_date)) (string >) (ensureNumericEntity (concat (date 2004 -1 -1) (date 2010 -1 -1)))))
which recipe takes as much time to prepare as rice pudding	 (listValue (filter (getProperty (singleton en.recipe) (string !type)) (string preparation_time) (string =) (getProperty en.recipe.rice_pudding (string preparation_time))))
show me recipes for lunch or dinner	 (listValue (concat en.meal.lunch en.meal.dinner))
what is the preparation of rice pudding	 (listValue (getProperty en.recipe.rice_pudding (string preparation_time)))
what is the cooking time of recipe	 (listValue (aggregate (string sum) (getProperty (getProperty (singleton en.recipe) (string !type)) (string cooking_time))))
ingredient in rice pudding and quiche	 (listValue (filter (getProperty (singleton en.ingredient) (string !type)) (reverse (string requires)) (string =) (concat en.recipe.rice_pudding en.recipe.quiche)))
what is a recipe posted later than 2004	 (listValue (filter (getProperty (singleton en.recipe) (string !type)) (ensureNumericProperty (string posting_date)) (string >) (ensureNumericEntity (date 2004 -1 -1))))
what meal has less than two recipes for it	 (listValue (countComparative (getProperty (singleton en.meal) (string !type)) (reverse (string meal)) (string <) (number 2) (getProperty (singleton en.recipe) (string !type))))
when was the rice pudding recipe posted	 (listValue (getProperty en.recipe.rice_pudding (string posting_date)))
show me a recipe that has a posting date of at least 2004	 (listValue (filter (getProperty (singleton en.recipe) (string !type)) (ensureNumericProperty (string posting_date)) (string >=) (ensureNumericEntity (date 2004 -1 -1))))
show me recipes good for at least two meals	 (listValue (countComparative (getProperty (singleton en.recipe) (string !type)) (string meal) (string >=) (number 2) (getProperty (singleton en.meal) (string !type))))
show me recipes posted in 2004	 (listValue (filter (getProperty (singleton en.recipe) (string !type)) (string posting_date) (string =) (date 2004 -1 -1)))
what recipe has at the most no more than two cuisines	 (listValue (countComparative (getProperty (singleton en.recipe) (string !type)) (string cuisine) (string <=) (number 2)))
what recipe calls for two or less ingredients	 (listValue (countComparative (getProperty (singleton en.recipe) (string !type)) (string requires) (string <=) (number 2) (getProperty (singleton en.ingredient) (string !type))))
find me the recipes need more than one ingredients	 (listValue (countComparative (getProperty (singleton en.recipe) (string !type)) (string requires) (string >=) (number 2) (getProperty (singleton en.ingredient) (string !type))))
show me recipes not posted in 2004	 (listValue (filter (getProperty (singleton en.recipe) (string !type)) (string posting_date) (string !=) (date 2004 -1 -1)))
