name all the lakes of us	(answer (lake (loc (countryid usa))))
what is the highest point in florida	(answer (highest (place (loc (stateid florida)))))
what are the high points of states surrounding mississippi	(answer (high_point (state (next_to (stateid mississippi)))))
what state has the shortest river	(answer (state (loc (shortest (river all)))))
what is the tallest mountain in the united states	(answer (highest (mountain (loc (countryid usa)))))
what is the capital of maine	(answer (capital (loc (stateid maine))))
what are the populations of states through which the mississippi river runs	(answer (population (state (traverse (riverid mississippi)))))
name all the lakes of us	(answer (lake (loc (countryid usa))))
which states border states through which the mississippi traverses	(answer (state (next_to (state (traverse (riverid mississippi))))))
what is the highest mountain in alaska	(answer (highest (mountain (loc (stateid alaska)))))
what is the population of illinois	(answer (population (stateid illinois)))
name all the rivers in colorado	(answer (river (loc (stateid colorado))))
in which state does the highest point in usa exist	(answer (state (loc (highest (place (loc (countryid usa)))))))
which state is the city denver located in	(answer (state (loc (cityid denver _))))
what is the lowest point in texas	(answer (lowest (place (loc (stateid texas)))))
how many states have a city called rochester	(answer (count (state (loc (city (cityid rochester _))))))
which capitals are in the states that border texas	(answer (capital (loc (state (next_to (stateid texas))))))
how many people live in austin	(answer (population (cityid austin _)))
what states have rivers named colorado	(answer (state (loc (river (riverid colorado)))))
what is the size of texas	(answer (size (stateid texas)))
what is the shortest river in the usa	(answer (shortest (river (loc (countryid usa)))))
what are the major cities of the us	(answer (major (city (loc (countryid usa)))))
which state border kentucky	(answer (state (next_to (stateid kentucky))))
what is the population of oregon	(answer (population (stateid oregon)))
what states have a city named austin	(answer (state (loc (city (cityid austin _)))))
what is the highest elevation in south carolina	(answer (highest (place (loc (stateid south_carolina)))))
how many people live in austin texas	(answer (population (cityid austin tx)))
what are the rivers in the state of texas	(answer (river (loc (stateid texas))))
what is the lowest point of colorado	(answer (lowest (place (loc (stateid colorado)))))
what is the population of atlanta	(answer (population (cityid atlanta _)))
what rivers are in utah	(answer (river (loc (stateid utah))))
what river runs through the most states	(answer (most (river (traverse (state all)))))
what is the population of sacramento	(answer (population (cityid sacramento _)))
could you tell me what is the highest point in the state of oregon	(answer (highest (place (loc (stateid oregon)))))
which states does the mississippi river run through	(answer (state (traverse (riverid mississippi))))
what are the major cities in the smallest state in the us	(answer (major (city (loc (smallest (state (loc (countryid usa))))))))
how high is guadalupe peak	(answer (elevation (placeid guadalupe_peak)))
what river runs through illinois	(answer (river (traverse (stateid illinois))))
how long is the mississippi river	(answer (len (riverid mississippi)))
how high is the highest point in the largest state	(answer (elevation (highest (place (loc (largest (state all)))))))
what is the area of south carolina	(answer (area (stateid south_carolina)))
what are the states through which the longest river runs	(answer (state (traverse (longest (river all)))))
where is new orleans	(answer (loc (cityid new_orleans _)))
in what state is mount mckinley	(answer (state (loc (placeid mount_mckinley))))
what state has highest elevation	(answer (state (loc (highest (place all)))))
what is the size of california	(answer (size (stateid california)))
what is the smallest state that borders texas	(answer (smallest (state (next_to (stateid texas)))))
how many citizens in alabama	(answer (population (stateid alabama)))
in which state is rochester	(answer (state (loc (cityid rochester _))))
how many states in the us does the shortest river run through	(answer (count (intersection (state (loc (countryid usa))) (traverse (shortest (river all))))))
what is the biggest state in continental us	(answer (largest (state (loc (countryid usa)))))
what is the area of the largest state	(answer (area (largest (state all))))
where is mount whitney	(answer (loc (placeid mount_whitney)))
how many states does iowa border	(answer (count (state (next_to (stateid iowa)))))
which states does the longest river cross	(answer (state (traverse (longest (river all)))))
what river flows through kansas	(answer (river (traverse (stateid kansas))))
what is the population of austin texas	(answer (population (cityid austin tx)))
what is the capital of vermont	(answer (capital (loc (stateid vermont))))
which states border colorado	(answer (state (next_to (stateid colorado))))
how long is the mississippi	(answer (len (riverid mississippi)))
what state has the largest population density	(answer (largest_one (density (state all))))
what states border georgia	(answer (state (next_to (stateid georgia))))
what is the capital of pennsylvania	(answer (capital (loc (stateid pennsylvania))))
what are the biggest rivers in texas	(answer (longest (river (loc (stateid texas)))))
what is the longest river in the united states	(answer (longest (river (loc (countryid usa)))))
what is the capital of utah	(answer (capital (loc (stateid utah))))
what state has the smallest population density	(answer (smallest_one (density (state all))))
which capitals are not major cities	(answer (exclude (capital all) (major (city all))))
what is the biggest city in nebraska	(answer (largest (city (loc (stateid nebraska)))))
what is the population of texas	(answer (population (stateid texas)))
what is the shortest river in the united states	(answer (shortest (river (loc (countryid usa)))))
what is the population of rhode island	(answer (population (stateid rhode_island)))
what is the state with the lowest point	(answer (state (loc (lowest (place all)))))
what is the longest river in new york	(answer (longest (river (loc (stateid new_york)))))
what is the longest river that runs through a state that borders tennessee	(answer (longest (river (traverse (state (next_to (stateid tennessee)))))))
how many major cities are in arizona	(answer (count (major (city (loc (stateid arizona))))))
what are the neighboring states for michigan	(answer (state (next_to (stateid michigan))))
what state that borders texas is the largest	(answer (largest (state (next_to (stateid texas)))))
what is the shortest river	(answer (shortest (river all)))
how many states border the state that borders the most states	(answer (count (state (next_to (most (state (next_to (state all))))))))
which state is the largest city in montana in	(answer (state (loc (largest (city (loc (stateid montana)))))))
what is the population of washington dc	(answer (population (cityid washington dc)))
what is the most populous city in texas	(answer (largest_one (population (city (loc (stateid texas))))))
what is the capital of hawaii	(answer (capital (loc (stateid hawaii))))
what is capital of iowa	(answer (capital (loc (stateid iowa))))
where is san diego	(answer (loc (cityid san_diego _)))
what are the major cities in delaware	(answer (major (city (loc (stateid delaware)))))
what is the lowest point in louisiana	(answer (lowest (place (loc (stateid louisiana)))))
which state has the highest peak in the country	(answer (state (loc (highest (place all)))))
what texas city has the largest population	(answer (largest_one (population (city (loc (stateid texas))))))
what capital is the largest in the us	(answer (largest (capital (loc (countryid usa)))))
what is the population of new york	(answer (population (stateid new_york)))
what is the population of the capital of the smallest state	(answer (population (capital (loc (smallest (state all))))))
what is the area of alaska	(answer (area (stateid alaska)))
what is the population of california	(answer (population (stateid california)))
which state has the longest river	(answer (state (loc (longest (river all)))))
what is the capital of texas	(answer (capital (loc (stateid texas))))
give me the cities which are in texas	(answer (city (loc (stateid texas))))
what states border kentucky	(answer (state (next_to (stateid kentucky))))
how high is the highest point of florida	(answer (elevation (highest (place (loc (stateid florida))))))
what are the major cities in north carolina	(answer (major (city (loc (stateid north_carolina)))))
what is the highest point in the state with capital des moines	(answer (highest (place (loc (state (loc (capital (cityid des_moines _))))))))
what is the lowest point in california	(answer (lowest (place (loc (stateid california)))))
what is the biggest city in wyoming	(answer (largest (city (loc (stateid wyoming)))))
what is the largest state bordering texas	(answer (largest (state (next_to (stateid texas)))))
what is the smallest city in hawaii	(answer (smallest (city (loc (stateid hawaii)))))
what is the area of the states	(answer (area (state all)))
what is the area of idaho	(answer (area (stateid idaho)))
what state has the most rivers running through it	(answer (most (state (traverse (river all)))))
what is the population of springfield missouri	(answer (population (cityid springfield mo)))
what is the most populated state bordering oklahoma	(answer (largest_one (population (state (next_to (stateid oklahoma))))))
what is the number of neighboring states for kentucky	(answer (count (state (next_to (stateid kentucky)))))
what is the average population per square km in pennsylvania	(answer (density (stateid pennsylvania)))
what state has the highest population density	(answer (largest_one (density (state all))))
what is the tallest mountain in america	(answer (highest (mountain (loc (countryid usa)))))
what is the highest point of the state with the largest area	(answer (highest (place (loc (largest_one (area (state all)))))))
what are the states	(answer (state all))
how many rivers in washington	(answer (count (river (loc (stateid washington)))))
what are the populations of states through which the mississippi river runs	(answer (population (state (traverse (riverid mississippi)))))
what is the biggest river in illinois	(answer (longest (river (loc (stateid illinois)))))
what is the capital of michigan	(answer (capital (loc (stateid michigan))))
what is the total population of the states that border texas	(answer (sum (population (state (next_to (stateid texas))))))
what states border rhode island	(answer (state (next_to (stateid rhode_island))))
what is the biggest city in oregon	(answer (largest (city (loc (stateid oregon)))))
what is the lowest point in wisconsin	(answer (lowest (place (loc (stateid wisconsin)))))
what are the rivers in the state of indiana	(answer (river (loc (stateid indiana))))
what is the population of austin	(answer (population (cityid austin _)))
what is the smallest city in arkansas	(answer (smallest (city (loc (stateid arkansas)))))
give me the longest river that passes through the us	(answer (longest (river (traverse (countryid usa)))))
how long is the missouri river	(answer (len (riverid missouri)))
which state has the largest city	(answer (state (loc (largest (city all)))))
what is the lowest elevation in pennsylvania	(answer (lowest (place (loc (stateid pennsylvania)))))
what is the longest river in the state with the highest point	(answer (longest (river (loc (state (loc (highest (place all))))))))
what states does the colorado river run through	(answer (state (traverse (riverid colorado))))
what are the states that the potomac runs through	(answer (state (traverse (riverid potomac))))
what is the biggest city in the usa	(answer (largest (city (loc (countryid usa)))))
what state has no rivers	(answer (exclude (state all) (loc (river all))))
what is the highest point in rhode island	(answer (highest (place (loc (stateid rhode_island)))))
name the states which have no surrounding states	(answer (exclude (state all) (next_to (state all))))
what is the population of atlanta ga	(answer (population (cityid atlanta ga)))
how many square kilometers in the us	(answer (area (countryid usa)))
what is the population of idaho	(answer (population (stateid idaho)))
what is the adjacent state of california	(answer (state (next_to (stateid california))))
what is the smallest state through which the longest river runs	(answer (smallest (state (traverse (longest (river all))))))
what are the names of the major cities in illinois	(answer (major (city (loc (stateid illinois)))))
how many states does the colorado river run through	(answer (count (state (traverse (riverid colorado)))))
how many states does the colorado river flow through	(answer (count (state (traverse (riverid colorado)))))
what are the major cities in kansas	(answer (major (city (loc (stateid kansas)))))
which states border texas	(answer (state (next_to (stateid texas))))
how many people live in new york	(answer (population (stateid new_york)))
what are the largest cities in the states that border the largest state	(answer (largest (city (loc (state (next_to (largest (state all))))))))
which states have points that are higher than the highest point in texas	(answer (state (loc (place (higher (highest (place (loc (stateid texas)))))))))
what is the river that cross over ohio	(answer (river (traverse (stateid ohio))))
what is the largest city in michigan	(answer (largest (city (loc (stateid michigan)))))
how many rivers are in the state with the highest point	(answer (count (river (loc (state (loc (highest (place all))))))))
what cities are located in pennsylvania	(answer (city (loc (stateid pennsylvania))))
what is the state with the lowest population	(answer (smallest_one (population (state all))))
what is the highest point in each state whose lowest point is sea level	(answer (highest (place (loc (state (loc (lowest (place (elevation 0)))))))))
give me the cities in usa	(answer (city (loc (countryid usa))))
how many states does the missouri river run through	(answer (count (state (traverse (riverid missouri)))))
what state has the city with the largest population	(answer (state (loc (largest_one (population (city all))))))
which is the shortest river	(answer (shortest (river all)))
how many states border alaska	(answer (count (state (next_to (stateid alaska)))))
what is the population of dallas	(answer (population (cityid dallas _)))
where is san jose	(answer (loc (cityid san_jose _)))
what states border states that border colorado	(answer (state (next_to (state (next_to (stateid colorado))))))
what rivers flow through the state with the largest population	(answer (river (traverse (largest_one (population (state all))))))
whats the largest city	(answer (largest (city all)))
what is the capital of the alabama state	(answer (capital (loc (stateid alabama))))
what states border arkansas	(answer (state (next_to (stateid arkansas))))
what is the population of denver	(answer (population (cityid denver _)))
what is the longest river in america	(answer (longest (river (loc (countryid usa)))))
where is massachusetts	(answer (loc (stateid massachusetts)))
what state has the smallest area	(answer (smallest_one (area (state all))))
what major rivers run through illinois	(answer (major (river (traverse (stateid illinois)))))
how many cities does the usa have	(answer (count (city (loc (countryid usa)))))
how many people live in california	(answer (population (stateid california)))
what are the major rivers in the us	(answer (major (river (loc (countryid usa)))))
how many states does the mississippi river run through	(answer (count (state (traverse (riverid mississippi)))))
what is the area of texas	(answer (area (stateid texas)))
what is the length of the river that traverses the most states	(answer (len (most (river (traverse (state all))))))
what is the length of the longest river in the usa	(answer (len (longest (river (loc (countryid usa))))))
can you tell me the capital of texas	(answer (capital (loc (stateid texas))))
what is the largest city in minnesota by population	(answer (largest_one (population (city (loc (stateid minnesota))))))
what is the smallest state in the usa	(answer (smallest (state (loc (countryid usa)))))
what states neighbor maine	(answer (state (next_to (stateid maine))))
what states high point is higher than that of colorado	(answer (state (high_point (higher (high_point (stateid colorado))))))
what is the highest mountain in texas	(answer (highest (mountain (loc (stateid texas)))))
what are the major cities in texas	(answer (major (city (loc (stateid texas)))))
what are the states that border the state with the greatest population	(answer (state (next_to (largest_one (population (state all))))))
what rivers run through colorado	(answer (river (traverse (stateid colorado))))
how many rivers are there in us	(answer (count (river (loc (countryid usa)))))
how many rivers are in new york	(answer (count (river (loc (stateid new_york)))))
which rivers are in alaska	(answer (river (loc (stateid alaska))))
what is the longest river flowing through new york	(answer (longest (river (traverse (stateid new_york)))))
what rivers run through west virginia	(answer (river (traverse (stateid west_virginia))))
what are the capitals of the states that border texas	(answer (capital (loc (state (next_to (stateid texas))))))
what is the area of california	(answer (area (stateid california)))
how many states have a city named springfield	(answer (count (state (loc (city (cityid springfield _))))))
what is the biggest city in texas	(answer (largest (city (loc (stateid texas)))))
how many cities named austin are there in the usa	(answer (count (intersection (city (cityid austin _)) (loc (countryid usa)))))
what are the major cities in the largest state	(answer (major (city (loc (largest (state all))))))
which states does the colorado river run through	(answer (state (traverse (riverid colorado))))
what is the largest city in wisconsin	(answer (largest (city (loc (stateid wisconsin)))))
how big is alaska	(answer (size (stateid alaska)))
what state contains the highest point in the us	(answer (state (loc (highest (place (loc (countryid usa)))))))
how big is north dakota	(answer (size (stateid north_dakota)))
which rivers flow through alaska	(answer (river (traverse (stateid alaska))))
what is the highest point in the us	(answer (highest (place (loc (countryid usa)))))
what is the shortest river in texas	(answer (shortest (river (loc (stateid texas)))))
what are the major cities in the states through which the major river in virginia runs	(answer (major (city (loc (state (traverse (major (river (loc (stateid virginia))))))))))
what rivers are in oregon	(answer (river (loc (stateid oregon))))
what is the lowest point in the united states	(answer (lowest (place (loc (countryid usa)))))
how many states have cities or towns named springfield	(answer (count (state (loc (city (cityid springfield _))))))
what is the population of south dakota	(answer (population (stateid south_dakota)))
what is the capital of the state with the highest point	(answer (capital (loc (state (loc (highest (place all)))))))
what state has the highest elevation	(answer (state (loc (highest (place all)))))
what states are next to texas	(answer (state (next_to (stateid texas))))
what is the longest river that passes the states that border the state that borders the most states	(answer (longest (river (traverse (state (next_to (most (state (next_to (state all))))))))))
which states border hawaii	(answer (state (next_to (stateid hawaii))))
how many major cities are there in oregon	(answer (count (major (city (loc (stateid oregon))))))
what is the population of springfield south dakota	(answer (population (cityid springfield sd)))
how many rivers run through texas	(answer (count (river (traverse (stateid texas)))))
what state has the most major rivers running through it	(answer (most (state (traverse (major (river all))))))
what are the lakes in states bordering texas	(answer (lake (loc (state (next_to (stateid texas))))))
people in boulder	(answer (population (cityid boulder _)))
what rivers are in nevada	(answer (river (loc (stateid nevada))))
where is fort wayne	(answer (loc (cityid fort_wayne _)))
where is indianapolis	(answer (loc (cityid indianapolis _)))
what states border states that border states that border states that border texas	(answer (state (next_to (state (next_to (state (next_to (state (next_to (stateid texas))))))))))
population of boulder	(answer (population (cityid boulder _)))
what are the major cities of the united states	(answer (major (city (loc (countryid usa)))))
show major cities in colorado	(answer (major (city (loc (stateid colorado)))))
what state is columbus the capital of	(answer (state (loc (capital (cityid columbus _)))))
what is the area of all the states combined	(answer (sum (area (state all))))
what is the average population per square km in the us	(answer (density (countryid usa)))
what is the largest state that borders california	(answer (largest (state (next_to (stateid california)))))
what is the population of montana	(answer (population (stateid montana)))
what are the populations of all the major cities in montana	(answer (population (major (city (loc (stateid montana))))))
which rivers run through the state with the lowest elevation in the usa	(answer (river (traverse (state (loc (lowest (place (loc (countryid usa)))))))))
what rivers flow through the largest state	(answer (river (traverse (largest (state all)))))
what is the area of maine	(answer (area (stateid maine)))
what are major rivers in texas	(answer (major (river (loc (stateid texas)))))
what is the population density of the state with the smallest population	(answer (density (smallest_one (population (state all)))))
what is the highest point in wyoming	(answer (highest (place (loc (stateid wyoming)))))
what states border delaware	(answer (state (next_to (stateid delaware))))
which state has the most rivers running through it	(answer (most (state (traverse (river all)))))
what is largest capital	(answer (largest (capital all)))
what is the state with the largest population density	(answer (largest_one (density (state all))))
what states have towns named springfield	(answer (state (loc (city (cityid springfield _)))))
what is the smallest city in the largest state	(answer (smallest (city (loc (largest (state all))))))
what mountains are in alaska	(answer (mountain (loc (stateid alaska))))
what rivers flow through colorado	(answer (river (traverse (stateid colorado))))
which state has the least population density	(answer (smallest_one (density (state all))))
how many inhabitants does montgomery have	(answer (population (cityid montgomery _)))
what city has the largest population	(answer (largest_one (population (city all))))
what is the largest state	(answer (largest (state all)))
of the states washed by the mississippi river which has the lowest point	(answer (state (loc (lowest (place (loc (state (traverse (riverid mississippi)))))))))
what is the area of the state with the smallest population density	(answer (area (smallest_one (density (state all)))))
which state contains most rivers	(answer (most (state (loc (river all)))))
what is the longest river in mississippi	(answer (longest (river (loc (stateid mississippi)))))
what is the capital of the largest state	(answer (capital (loc (largest (state all)))))
what state has the largest population	(answer (largest_one (population (state all))))
name the rivers in arkansas	(answer (river (loc (stateid arkansas))))
what are the populations of states through which the mississippi river runs	(answer (population (state (traverse (riverid mississippi)))))
what is the population of arizona	(answer (population (stateid arizona)))
what state borders the state with the smallest population	(answer (state (next_to (smallest_one (population (state all))))))
what is the total area of the usa	(answer (area (countryid usa)))
what is the population of seattle washington	(answer (population (cityid seattle wa)))
what is the size of the largest state in the usa	(answer (size (largest (state (loc (countryid usa))))))
what state has the capital salem	(answer (state (loc (capital (cityid salem _)))))
which is the lowest point of the states that the mississippi runs through	(answer (lowest (place (loc (state (traverse (riverid mississippi)))))))
how many major cities are in texas	(answer (count (major (city (loc (stateid texas))))))
what is the capital city of the largest state in the us	(answer (capital (city (loc (largest (state (loc (countryid usa))))))))
what are the major cities in rhode island	(answer (major (city (loc (stateid rhode_island)))))
what state has the most people	(answer (largest_one (population (state all))))
what is the largest city of kansas	(answer (largest (city (loc (stateid kansas)))))
what is the area of the state with the capital albany	(answer (area (state (loc (capital (cityid albany _))))))
what is the longest river that flows through colorado	(answer (longest (river (traverse (stateid colorado)))))
how many rivers does alaska have	(answer (count (river (loc (stateid alaska)))))
how big is massachusetts	(answer (size (stateid massachusetts)))
how large is the largest city in alaska	(answer (size (largest (city (loc (stateid alaska))))))
how many cities are there in usa	(answer (count (city (loc (countryid usa)))))
what states capital is dover	(answer (state (capital (cityid dover _))))
what states border new hampshire	(answer (state (next_to (stateid new_hampshire))))
what is the shortest river in nebraska	(answer (shortest (river (loc (stateid nebraska)))))
how many states border hawaii	(answer (count (state (next_to (stateid hawaii)))))
what state is dallas in	(answer (state (loc (cityid dallas _))))
what city has the least population	(answer (smallest_one (population (city all))))
how many people stay in utah	(answer (population (stateid utah)))
what state has the sparsest population density	(answer (smallest_one (density (state all))))
what is the largest state that borders the state with the lowest point in the usa	(answer (largest (state (next_to (state (loc (lowest (place (loc (countryid usa))))))))))
what is the largest city in texas	(answer (largest (city (loc (stateid texas)))))
what is the largest state in the us	(answer (largest (state (loc (countryid usa)))))
which state has the most people	(answer (largest_one (population (state all))))
what rivers are in new mexico	(answer (river (loc (stateid new_mexico))))
what is the area of maryland in square kilometers	(answer (area (stateid maryland)))
how many states are there in united states	(answer (count (state (loc (countryid usa)))))
how many major cities are in states bordering nebraska	(answer (count (major (city (loc (state (next_to (stateid nebraska))))))))
what is the population of the largest state	(answer (population (largest (state all))))
what is the size of florida	(answer (size (stateid florida)))
how many rivers are in missouri	(answer (count (river (loc (stateid missouri)))))
how many rivers are there in texas	(answer (count (river (loc (stateid texas)))))
what is the highest point in the state with the capital des moines	(answer (highest (place (loc (state (loc (capital (cityid des_moines _))))))))
what is the population of seattle	(answer (population (cityid seattle _)))
what is the highest point in colorado	(answer (highest (place (loc (stateid colorado)))))
which states border arizona	(answer (state (next_to (stateid arizona))))
what rivers run through the state with the lowest point in the usa	(answer (river (traverse (state (loc (lowest (place (loc (countryid usa)))))))))
what is the population of minnesota	(answer (population (stateid minnesota)))
what state has the city with the most population	(answer (state (loc (largest_one (population (city all))))))
which states have a major city named austin	(answer (state (loc (major (city (cityid austin _))))))
which states have points higher than the highest point in colorado	(answer (state (loc (place (higher (highest (place (loc (stateid colorado)))))))))
what is the highest point in the state with the smallest population	(answer (highest (place (loc (smallest_one (population (state all)))))))
where is new hampshire	(answer (loc (stateid new_hampshire)))
which state borders florida	(answer (state (next_to (stateid florida))))
how many rivers in texas are longer than the red	(answer (count (intersection (river (loc (stateid texas))) (longer (riverid red)))))
how many rivers do not traverse the state with the capital albany	(answer (count (exclude (river all) (traverse (state (loc (capital (cityid albany _))))))))
what are the populations of states through which the mississippi river runs	(answer (population (state (traverse (riverid mississippi)))))
through which states does the mississippi run	(answer (state (traverse (riverid mississippi))))
what states are next to the mississippi	(answer (state (next_to (riverid mississippi))))
give me the cities in virginia	(answer (city (loc (stateid virginia))))
what are the capital cities of the states which border texas	(answer (capital (city (loc (state (next_to (stateid texas)))))))
what state that borders texas has the highest population	(answer (largest_one (population (state (next_to (stateid texas))))))
what state is the state with the most rivers	(answer (state (most (state (loc (river all))))))
what state has the least population density	(answer (smallest_one (density (state all))))
what are the major cities in ohio	(answer (major (city (loc (stateid ohio)))))
which states does the missouri river run through	(answer (state (traverse (riverid missouri))))
what is the biggest city in arizona	(answer (largest (city (loc (stateid arizona)))))
how many people live in hawaii	(answer (population (stateid hawaii)))
how many people live in the smallest state bordering wyoming	(answer (population (smallest (state (next_to (stateid wyoming))))))
what is the name of the state with the lowest point	(answer (state (loc (lowest (place all)))))
what rivers flow through missouri	(answer (river (traverse (stateid missouri))))
what is the elevation of death valley	(answer (elevation (placeid death_valley)))
what river flows through texas	(answer (river (traverse (stateid texas))))
how high are the highest points of all the states	(answer (elevation (highest (place (loc (state all))))))
what is the capital of new hampshire	(answer (capital (loc (stateid new_hampshire))))
how long is the rio grande river	(answer (len (riverid rio_grande)))
which state borders most states	(answer (most (state (next_to (state all)))))
how many states does missouri border	(answer (count (state (next_to (stateid missouri)))))
where is austin	(answer (loc (cityid austin _)))
how high is the highest point of delaware	(answer (elevation (highest (place (loc (stateid delaware))))))
where is the highest point in montana	(answer (loc (highest (place (loc (stateid montana))))))
what states border states that border the state with the largest population	(answer (state (next_to (state (next_to (largest_one (population (state all))))))))
what is the height of the highest mountain in texas	(answer (elevation (highest (mountain (loc (stateid texas))))))
what state has the city flint	(answer (state (loc (cityid flint _))))
what is the state with the largest density in usa	(answer (largest_one (density (state (loc (countryid usa))))))
what cities in texas have the highest number of citizens	(answer (largest_one (population (city (loc (stateid texas))))))
what states border missouri	(answer (state (next_to (stateid missouri))))
give me the largest state	(answer (largest (state all)))
which state has the sparsest population density	(answer (smallest_one (density (state all))))
which states border alabama	(answer (state (next_to (stateid alabama))))
what rivers flow through states that alabama borders	(answer (river (traverse (state (next_to (stateid alabama))))))
what are the major cities in wyoming	(answer (major (city (loc (stateid wyoming)))))
what are the highest points of states surrounding mississippi	(answer (highest (place (loc (state (next_to (stateid mississippi)))))))
through which states does the mississippi flow	(answer (state (traverse (riverid mississippi))))
where is scotts valley	(answer (loc (cityid scotts_valley _)))
what are the major lakes in united states	(answer (major (lake (loc (countryid usa)))))
what is the largest city in missouri	(answer (largest (city (loc (stateid missouri)))))
what states border alaska	(answer (state (next_to (stateid alaska))))
what state has the largest city	(answer (state (loc (largest (city all)))))
what rivers run through maine	(answer (river (traverse (stateid maine))))
give me the lakes in california	(answer (lake (loc (stateid california))))
what is the combined population of all 50 states	(answer (sum (population (state all))))
how high is the highest point of louisiana	(answer (elevation (highest (place (loc (stateid louisiana))))))
what is the longest river in pennsylvania	(answer (longest (river (loc (stateid pennsylvania)))))
what is the capital of maryland	(answer (capital (loc (stateid maryland))))
what state is the biggest	(answer (largest (state all)))
which states border iowa	(answer (state (next_to (stateid iowa))))
which states border alaska	(answer (state (next_to (stateid alaska))))
what is the largest state in usa	(answer (largest (state (loc (countryid usa)))))
what are the major cities in california	(answer (major (city (loc (stateid california)))))
what is the largest state traversed by the mississippi river	(answer (largest (state (traverse (riverid mississippi)))))
which rivers run through states bordering new mexico	(answer (river (traverse (state (next_to (stateid new_mexico))))))
what is the lowest point in the state of texas	(answer (lowest (place (loc (stateid texas)))))
what is the smallest state bordering ohio	(answer (smallest (state (next_to (stateid ohio)))))
how many states are next to major rivers	(answer (count (state (next_to (major (river all))))))
what is the lowest point of the us	(answer (lowest (place (loc (countryid usa)))))
which state has the greatest density	(answer (largest_one (density (state all))))
how many states border the largest state	(answer (count (state (next_to (largest (state all))))))
what is the longest river that does not run through texas	(answer (longest (exclude (river all) (traverse (stateid texas)))))
give me all the states of usa	(answer (state (loc (countryid usa))))
what is the density of texas	(answer (density (stateid texas)))
what is the smallest city of the smallest state in the us	(answer (smallest (city (loc (smallest (state (loc (countryid usa))))))))
what is the highest point in kansas	(answer (highest (place (loc (stateid kansas)))))
what is the population in boston	(answer (population (cityid boston _)))
how many people are in the state of nevada	(answer (population (stateid nevada)))
what is the population density of texas	(answer (density (stateid texas)))
how many people live in washington dc	(answer (population (cityid washington dc)))
give me the cities in texas	(answer (city (loc (stateid texas))))
how long is the shortest river in the usa	(answer (len (shortest (river (loc (countryid usa))))))
how many states have major rivers	(answer (count (state (loc (major (river all))))))
what is the population density of the smallest state	(answer (density (smallest (state all))))
which states border michigan	(answer (state (next_to (stateid michigan))))
what cities in texas have the highest populations	(answer (largest_one (population (city (loc (stateid texas))))))
what rivers run through the states that border the state with the capital atlanta	(answer (river (traverse (state (next_to (state (loc (capital (cityid atlanta _)))))))))
what is the highest point in the country	(answer (highest (place (loc (countryid usa)))))
how many people live in kalamazoo	(answer (population (cityid kalamazoo _)))
how many major cities are in florida	(answer (count (major (city (loc (stateid florida))))))
what state has the greatest population density	(answer (largest_one (density (state all))))
how many rivers are found in colorado	(answer (count (river (loc (stateid colorado)))))
what is the lowest point of the state with the largest area	(answer (lowest (place (loc (largest_one (area (state all)))))))
what states border texas	(answer (state (next_to (stateid texas))))
how many states border at least one other state	(answer (count (state (next_to (state all)))))
which states border no other states	(answer (exclude (state all) (next_to (state all))))
what rivers run through austin texas	(answer (river (traverse (cityid austin tx))))
how many people live in new hampshire	(answer (population (stateid new_hampshire)))
what is the capital of indiana	(answer (capital (loc (stateid indiana))))
what states border the states with the most cities	(answer (state (next_to (most (state (loc (city all)))))))
what is the area of the smallest state	(answer (area (smallest (state all))))
which states border new york	(answer (state (next_to (stateid new_york))))
what is the population of maine	(answer (population (stateid maine)))
what is the biggest city in the smallest state	(answer (largest (city (loc (smallest (state all))))))
what is the elevation of the highest point in the usa	(answer (elevation (highest (place (loc (countryid usa))))))
what state borders the least states excluding alaska and excluding hawaii	(answer (fewest (state (next_to (exclude (exclude (state all) (stateid alaska)) (stateid hawaii))))))
what is the highest point in new mexico	(answer (highest (place (loc (stateid new_mexico)))))
what is the biggest state	(answer (largest (state all)))
how many people live in spokane washington	(answer (population (cityid spokane wa)))
what states does the shortest river run through	(answer (state (traverse (shortest (river all)))))
how long is rio grande	(answer (len (riverid rio_grande)))
how many people live in texas	(answer (population (stateid texas)))
where is the lowest spot in iowa	(answer (loc (lowest (place (loc (stateid iowa))))))
what are the populations of the states through which the mississippi river runs	(answer (population (state (traverse (riverid mississippi)))))
what is the lowest point in oregon	(answer (lowest (place (loc (stateid oregon)))))
what is the shortest river in alaska	(answer (shortest (river (loc (stateid alaska)))))
how many states border the mississippi river	(answer (count (state (next_to (riverid mississippi)))))
what is the most populated capital in the usa	(answer (largest_one (population (capital (loc (countryid usa))))))
what is the highest point in ohio	(answer (highest (place (loc (stateid ohio)))))
what states border wisconsin	(answer (state (next_to (stateid wisconsin))))
what states have a capital that is the highest point in the state	(answer (state (loc (capital (highest (place all))))))
how many states border colorado and border new mexico	(answer (count (state (intersection (next_to (stateid colorado)) (next_to (stateid new_mexico))))))
what are the major cities in missouri	(answer (major (city (loc (stateid missouri)))))
what are the major cities of texas	(answer (major (city (loc (stateid texas)))))
how many rivers are called color	(answer (count (river (riverid colorado))))
how high is the highest point in montana	(answer (elevation (highest (place (loc (stateid montana))))))
how many states have cities named austin	(answer (count (state (loc (city (cityid austin _))))))
which states does the missouri river pass through	(answer (state (traverse (riverid missouri))))
what is the biggest city in the us	(answer (largest (city (loc (countryid usa)))))
how big is new mexico	(answer (size (stateid new_mexico)))
how many people live in south dakota	(answer (population (stateid south_dakota)))
what state is pittsburgh in	(answer (state (loc (cityid pittsburgh _))))
what rivers run through arizona	(answer (river (traverse (stateid arizona))))
how many major rivers cross ohio	(answer (count (major (river (traverse (stateid ohio))))))
how many people in boulder	(answer (population (cityid boulder _)))
how many rivers are there in idaho	(answer (count (river (loc (stateid idaho)))))
sacramento is the capital of which state	(answer (state (loc (capital (cityid sacramento _)))))
how many cities are there in us	(answer (count (city (loc (countryid usa)))))
how many citizens live in california	(answer (population (stateid california)))
what state has the largest urban population	(answer (largest_one (population (state all))))
what states border the mississippi river	(answer (state (next_to (riverid mississippi))))
what can you tell me about the population of missouri	(answer (population (stateid missouri)))
what rivers do not run through tennessee	(answer (exclude (river all) (traverse (stateid tennessee))))
what is the largest city in a state that borders texas	(answer (largest (city (loc (state (next_to (stateid texas)))))))
name the longest river in us	(answer (longest (river (loc (countryid usa)))))
how many states does the mississippi run through	(answer (count (state (traverse (riverid mississippi)))))
what is the largest of the states that the rio grande runs through	(answer (largest (state (traverse (riverid rio_grande)))))
what is the size of the capital of texas	(answer (size (capital (loc (stateid texas)))))
what states have rivers running through them	(answer (state (traverse (river all))))
what states border hawaii	(answer (state (next_to (stateid hawaii))))
how many citizens in boulder	(answer (population (cityid boulder _)))
what states border states that border states that border florida	(answer (state (next_to (state (next_to (state (next_to (stateid florida))))))))
which states border the longest river in the usa	(answer (state (next_to (longest (river (loc (countryid usa)))))))
what is the population density of wyoming	(answer (density (stateid wyoming)))
how many people are there in iowa	(answer (population (stateid iowa)))
what is the highest point in the state with the most rivers	(answer (highest (place (loc (most (state (traverse (river all))))))))
number of citizens in boulder	(answer (population (cityid boulder _)))
what are the rivers of montana	(answer (river (loc (stateid montana))))
how many states border on the state whose capital is boston	(answer (count (state (next_to (state (loc (capital (cityid boston _))))))))
how many people live in washington	(answer (population (stateid washington)))
what is the largest state capital in population	(answer (largest_one (population (capital (state all)))))
what is the largest city in states that border california	(answer (largest (city (loc (state (next_to (stateid california)))))))
what is the most populous city in wyoming	(answer (largest_one (population (city (loc (stateid wyoming))))))
what is the population density in the state with capital austin	(answer (density (state (loc (capital (cityid austin _))))))
what is the population of portland maine	(answer (population (cityid portland me)))
which state is kalamazoo in	(answer (state (loc (cityid kalamazoo _))))
what is the population of the largest state that borders texas	(answer (population (largest (state (next_to (stateid texas))))))
what states border ohio	(answer (state (next_to (stateid ohio))))
what river is the longest one in the united states	(answer (longest (river (loc (countryid usa)))))
what is the population density of the state with the smallest area	(answer (density (smallest_one (area (state all)))))
what is the largest capital	(answer (largest (capital all)))
what state has the smallest capital	(answer (state (loc (smallest (capital all)))))
how many big cities are in pennsylvania	(answer (count (major (city (loc (stateid pennsylvania))))))
which states lie on the largest river in the united states	(answer (state (traverse (longest (river (loc (countryid usa)))))))
where is houston	(answer (loc (cityid houston _)))
what rivers flow through states that border the state with the largest population	(answer (river (traverse (state (next_to (largest_one (population (state all))))))))
what is the highest point in the smallest state	(answer (highest (place (loc (smallest (state all))))))
what river runs through virginia	(answer (river (traverse (stateid virginia))))
what state borders michigan	(answer (state (next_to (stateid michigan))))
name the major lakes in michigan	(answer (major (lake (loc (stateid michigan)))))
give me the cities in virginia	(answer (city (loc (stateid virginia))))
which river runs through the most states	(answer (most (river (traverse (state all)))))
how many people live in new mexico	(answer (population (stateid new_mexico)))
what is the largest city in alabama	(answer (largest (city (loc (stateid alabama)))))
how many people live in san francisco	(answer (population (cityid san_francisco _)))
what is the population of the capital of the largest state	(answer (population (capital (loc (largest (state all))))))
what is the longest river in the us	(answer (longest (river (loc (countryid usa)))))
what is the largest state that borders the state with the highest population	(answer (largest (state (next_to (largest_one (population (state all)))))))
show me all the major lakes in the us	(answer (major (lake (loc (countryid usa)))))
where is springfield	(answer (loc (cityid springfield _)))
what state is des moines located in	(answer (state (loc (cityid des_moines _))))
how many cities does texas have	(answer (count (city (loc (stateid texas)))))
what state is boston in	(answer (state (loc (cityid boston _))))
which rivers run through the state with the largest city in the us	(answer (river (traverse (state (loc (largest (city (loc (countryid usa)))))))))
states bordering iowa	(answer (state (next_to (stateid iowa))))
what states have no bordering state	(answer (exclude (state all) (next_to (state all))))
where is the lowest point in the us	(answer (loc (lowest (place (loc (countryid usa))))))
what are the major cities in oklahoma	(answer (major (city (loc (stateid oklahoma)))))
which state has the smallest area that borders texas	(answer (smallest_one (area (state (next_to (stateid texas))))))
what is the capital of the state with the highest elevation	(answer (capital (loc (state (loc (highest (place all)))))))
what states does the mississippi run through	(answer (state (traverse (riverid mississippi))))
where is mount whitney located	(answer (loc (placeid mount_whitney)))
which state has the largest density	(answer (largest_one (density (state all))))
what is the smallest city in washington	(answer (smallest (city (loc (stateid washington)))))
what are the major cities in new mexico	(answer (major (city (loc (stateid new_mexico)))))
how many people live in the capital of georgia	(answer (population (capital (loc (stateid georgia)))))
what state which the mississippi runs through has the largest population	(answer (largest_one (population (state (traverse (riverid mississippi))))))
state the state with the largest area	(answer (largest_one (area (state all))))
how many people live in riverside	(answer (population (cityid riverside _)))
what is the area of seattle	(answer (area (cityid seattle _)))
what capital has the largest population	(answer (largest_one (population (capital all))))
what is the capital of the state that borders the most states	(answer (capital (loc (most (state (next_to (state all)))))))
how many rivers run through the states bordering colorado	(answer (count (river (traverse (state (next_to (stateid colorado)))))))
what are the cities in california	(answer (city (loc (stateid california))))
what state is austin the capital of	(answer (state (loc (capital (cityid austin _)))))
how many people live in kansas	(answer (population (stateid kansas)))
what state borders the least states	(answer (fewest (state (next_to (state all)))))
which states border south dakota	(answer (state (next_to (stateid south_dakota))))
name the rivers in arkansas	(answer (river (loc (stateid arkansas))))
how long is the mississippi river in miles	(answer (len (riverid mississippi)))
what is the shortest river in the us	(answer (shortest (river (loc (countryid usa)))))
what is the biggest city in usa	(answer (largest (city (loc (countryid usa)))))
what is the capital of washington	(answer (capital (loc (stateid washington))))
how many cities are in montana	(answer (count (city (loc (stateid montana)))))
what is the capital of the state texas	(answer (capital (loc (stateid texas))))
what is the height of mount mckinley	(answer (elevation (placeid mount_mckinley)))
what is the city with the smallest population	(answer (smallest_one (population (city all))))
what is the biggest state in the usa	(answer (largest (state (loc (countryid usa)))))
how many major cities are in states bordering utah	(answer (count (major (city (loc (state (next_to (stateid utah))))))))
how many states border tennessee	(answer (count (state (next_to (stateid tennessee)))))
what states does the ohio river go through	(answer (state (traverse (riverid ohio))))
what is the longest river in the smallest state in the usa	(answer (longest (river (loc (smallest (state (loc (countryid usa))))))))
what is the smallest state by area	(answer (smallest_one (area (state all))))
what is the population of the capital of the largest state through which the mississippi runs	(answer (population (capital (loc (largest (state (traverse (riverid mississippi))))))))
what is the population of boston massachusetts	(answer (population (cityid boston ma)))
what cities in california	(answer (city (loc (stateid california))))
how big is the city of new york	(answer (size (cityid new_york _)))
what state has the most cities	(answer (most (state (loc (city all)))))
what is the longest river in the us	(answer (longest (river (loc (countryid usa)))))
name the 50 capitals in the usa	(answer (capital (loc (countryid usa))))
what is the capital of the state that borders the state that borders texas	(answer (capital (loc (state (next_to (state (next_to (stateid texas))))))))
which state has the red river	(answer (state (loc (riverid red))))
how many people live in chicago	(answer (population (cityid chicago _)))
what is the smallest city in alaska	(answer (smallest (city (loc (stateid alaska)))))
list the states	(answer (state all))
what is the biggest city in georgia	(answer (largest (city (loc (stateid georgia)))))
what states border states which the mississippi runs through	(answer (state (next_to (state (traverse (riverid mississippi))))))
how many cities are there in the us	(answer (count (city (loc (countryid usa)))))
how big is texas	(answer (size (stateid texas)))
what is the height of the highest point in the usa	(answer (elevation (highest (place (loc (countryid usa))))))
what are the populations of the states through which the mississippi runs	(answer (population (state (traverse (riverid mississippi)))))
what state has the smallest population	(answer (smallest_one (population (state all))))
how many states border texas	(answer (count (state (next_to (stateid texas)))))
which states do colorado river flow through	(answer (state (traverse (riverid colorado))))
what is the highest point in texas	(answer (highest (place (loc (stateid texas)))))
what is the longest river in california	(answer (longest (river (loc (stateid california)))))
what is the length of the river that runs through the most number of states	(answer (len (most (river (traverse (state all))))))
what is the most populous state in the us	(answer (largest_one (population (state (loc (countryid usa))))))
what is the capital of georgia	(answer (capital (loc (stateid georgia))))
what is the average population of the us by state	(answer (density (countryid usa)))
what is the area of new mexico	(answer (area (stateid new_mexico)))
what is the longest river in texas	(answer (longest (river (loc (stateid texas)))))
how many major cities are there	(answer (count (major (city all))))
how many rivers are in the state with the largest population	(answer (count (river (loc (largest_one (population (state all)))))))
what is the major cities in montana	(answer (major (city (loc (stateid montana)))))
what is the population of the major cities in wisconsin	(answer (population (major (city (loc (stateid wisconsin))))))
which states does not border texas	(answer (exclude (state all) (next_to (stateid texas))))
what river traverses the most states	(answer (most (river (traverse (state all)))))
what is the state with the lowest population density	(answer (smallest_one (density (state all))))
what states does the missouri river run through	(answer (state (traverse (riverid missouri))))
how many rivers are in colorado	(answer (count (river (loc (stateid colorado)))))
what is the shortest river in iowa	(answer (shortest (river (loc (stateid iowa)))))
what states border states that the mississippi runs through	(answer (state (next_to (state (traverse (riverid mississippi))))))
how many people are there in new york	(answer (population (stateid new_york)))
what is the city in texas with the largest population	(answer (largest_one (population (city (loc (stateid texas))))))
what is the highest elevation in new mexico	(answer (highest (place (loc (stateid new_mexico)))))
what is the highest point in the united states	(answer (highest (place (loc (countryid usa)))))
what is the population of the state with the largest area	(answer (population (largest_one (area (state all)))))
where is baton rouge	(answer (loc (cityid baton_rouge _)))
what states in the united states have a city of springfield	(answer (intersection (state (loc (countryid usa))) (loc (city (cityid springfield _)))))
how many cities are in louisiana	(answer (count (city (loc (stateid louisiana)))))
how many states are in the united states	(answer (count (state (loc (countryid usa)))))
what rivers run through louisiana	(answer (river (traverse (stateid louisiana))))
how many people live in the state with the largest population density	(answer (population (largest_one (density (state all)))))
what is the state with the highest elevation in the united states	(answer (state (loc (highest (place (loc (countryid usa)))))))
what state borders most other states	(answer (most (state (next_to (state all)))))
which states adjoin alabama	(answer (state (next_to (stateid alabama))))
what is the length of the colorado river in texas	(answer (len (intersection (riverid colorado) (river (loc (stateid texas))))))
what state has the highest population	(answer (largest_one (population (state all))))
what is the state that contains the highest point	(answer (state (loc (highest (place all)))))
what is the population density of south dakota	(answer (density (stateid south_dakota)))
what states have cities named austin	(answer (state (loc (city (cityid austin _)))))
how many people live in montana	(answer (population (stateid montana)))
